--------------------------------------------------------------------------------------------------------------------------------------------------------------------------------------------------------
--------------------------------------------------------------------------------------------------------------------------------------------------------------------------------------------------------
--------------------------------------------------------------------------------------------------------------------------------------------------------------------------------------------------------
--------M--M---Xo---X-B----X---X----Xo-X-----XX---o--------o----X----?-------------------o-M----------------o---X---X------------?--B-------o-XBo---------X--B---------------------B-----o--BM----------
---------X-------MMX-X----X-----------?---------------M-o-X-?--o----------X----BX---o---X--------B--------X-------X--?---------o-----?-XX----------------B---B----X-X--?--M---X-?----X-----M---------B--
---?----o--o--------X------o--X---------B-?-X-o--------------B-----XX------B--ooX-o-X------X--oXo-X----X----X---MB-----------X--X----------?------------XX----X----X-X-------------M--oB-----Xoo--?---?-
-------o-X-o-------BX-o--?--?--------B--X-----o--Bo------o--?-B--X----------X-----------o--oX----X------?----o-----X-----X---o--------X-----?--X--XXM----------X-X----BX----o----o--------?---X---------
---X------o----X-?------------MX?----X------?--B---Xo--?----------------M---X?-----X---------o----X?-------------?X--X?--X-X---?-------M--------o?-----------X-----X--oo---B----------------------X----v
-X-o----o-----------X-----------------M-----------------M----------o------M-----?-----------X-?-X------o-------X----M---o-------X--MX---------------?XX?---------o-oM---M?-----?-------X--MX-o------?--f
------X-----o---Xo----o??X---X------o--o-?-X--X-Xo-------X-----------------?--X--X--oX-X----------X--B----------M-X--X---X-----------B--o-------M-------o-X-X-X---X----------M----------------?--------f
---?-----X---------o------?M-o--o--M-------------o-----X----?--XM-Xo--------------X-------o----X-oo-----oo--X------o----X---------M---o-----------B-B?-------B--?---M------------------X----X--X----XX-f
----------------o--------------o--------M-B-------------M?---------------------X-------MX--------------------X?---M---o--------oo----X---------M-------X-B-XB----------------X----------------X------B-f
-?------------o--o--T-X----X-B------Mo-------------?-E-------T-----o------M--------X------------M-BX--------------------o-o---o-B--------------------M--M-----------------------B-o--------------X----Xf
-------?---M---X--o-|-----X----?-XX---MX-o-B--M-----BB-------|-------M------X-------------oBo--------M-XoM-----X---MXX----B--BX--X--X----X---X-----?---------oB-X--M------X-X-------B----X--o-X-?--o---f
m----o---------X----X--Xo-------X-X-X------------------X---X-X----X--------X---XX---X----B-----X--o-----------X----------X-X----------X-----X--------------------o--------B-o----X--XB-X-XX---X-------XX
X-XXXXX-XXXXXXXXXXXXXXXXXXXXXXXXXXXXXX-XXX-XXXXXXXX-XXXX-XXXXXXXXXXXXXXXXXXXXX-XX-XXXX-XXXX-XXXXXXXX-X-XXXXXXX-X-XXXX-XXXXXXXXXXXXXXXXXXXXXXXXXXXXXXXXXXXXXXXXXXXXXXXXXXXXXXXXXXXXXXXXXXXXXXXXXXXXXXXXXX
