--------------------------------------------------------------------------------------------------------------------------------------------------------------------------------------------------------
--------------------------------------------------------------------------------------------------------------------------------------------------------------------------------------------------------
--------------------------------------------------------------------------------------------------------------------------------------------------------------------------------------------------------
------X--------MX----------------B-X--M----------Mo---M-------oX---B------??-----------o--o------o---------X--B--o-Bo----------B----?---------------------X--?------------------M------------?M--?------
----X---X----B-----o------------?---o----X-----------------------X---oo-----X-o-----o--------B-------X----?--o----X------?-B--M----------oX----X---??---X-----X---o----M--X---X---BX--?X-XoB------X--M--
---------X-B------?-?----B--------X--M------X-o-MX-----?------------X-----------?B-X---?-------X-----------XB-o-oo----?----o------X-------X-----------X--------------o--o----o-X--X-------o--o----------
-M---Xo-----X----------o-----o----------X-XX---------------------X-------X?B------o---------------------?--------------X-X--X---------?-------oX---B------------B-----B--?--o---------?--------B--------
--------B--X---X-X---o-Xo-----B-M-oX------------Xo-X-XB?X--X-?----------o---X---o--?-X----?----B---X-M---X-X---------------X------B-------o-M-o-X?MX-Xo-o----M--------o------------oX---B---X--o-------v
-?X----X---------B---------X-----M---------------o-o-----XX---X-------BM-----------------------B-------XX--o----B---M-----X------X---o-?-Bo------------?-----------X-X--------M--o-----X---o-M--oX----Xf
--o---X------------o---X?---M-----------o-X-------------------X-----X--------M-o-?---X--X--------EXoo-M-X-----M-o----X------X-X-X-o---------o-------------------B------M----X--o-------o--------X------f
---X----------?----X------o--------M---X-----X-M-?-Xo-----o------X--Boo-X------X--X-X----X-MX--M-M---------XX------X------------------X------------o-Xoo--B-------o---------o-Xooo--------?-X--X-BMX---f
-o----X-B--------o--o------B-M-o-X--M-X---o---------------X----XX-----o----B-----o-X-o------o-------------M--X-o--o---------o-X------o----------X-X----XM---?M---?-M----oB?B--------M-X-?---B-X----X-B-f
-----o------------------X--X--X------M-B---------M-------X--X----X-X------M---?--------------------B--M-----X------?B--ooB---X------XX----o-----X-------------oX---------------oBB---------X----?------f
-----o-------------Xo-----M-XX-?B-?------o------------o----?-X--M--------------------o----M--------o---o-o----------X----o----------------oX-X-o---XB--B---------X----------X---------------ooB--X----Bf
m-------X------------X-X------------X---------------------------------------X---XB----X---------o-o------X-X----o--X-----XXX---------XX--X--o--o----B----------o------------B-----X----X--o---X--B-B-o-X
XXXXXXXXXXX-XXXXXXXX-XXXXXXXXX-XXXXXXXXXXXXXXXXXXXXXX-XXX-XXXXXXXXXXXXXXXXXXX-XXXXXXXXXX-XXXXXXXXXXXX-XXXXXXXXX-XXXXX-XXXXXXXXXXXXXXXXXXXXXXXXXXXXXXXXXXXXXXXXXXXXXXXXXXXXXXXXXXXXXXXXXXXXXXXXXXXXXXXXXX
