--------------------------------------------------------------------------------------------------------------------------------------------------------------------------------------------------------
--------------------------------------------------------------------------------------------------------------------------------------------------------------------------------------------------------
--------------------------------------------------------------------------------------------------------------------------------------------------------------------------------------------------------
-----------?---------XX--X--XXM--o-----o-------?--X------X-----------------B----X------o-Mo--------------o-X--B------E--M----X---oMXX--o-?-MB----B-------MXM--?-?-----------M-----M---------B--o--------
----X----------o-M-X--X-o-------o--------B-?-E--------XoB--------X------?X-X------MXo------oBB----?-------X----o--X-MX----X-X-M---------------?-------------?---------o-?----?----------------o-----o-X-
-----X---E-o?X----X-?o-------B----X---o------?--X--X?-----o---------XX-------Xo------------X-----------?---M-------------------M?----X--o-----------B----X-----B---------X-----o-----o-oM----B---X----o-
-------X-M------X----o------M---X-------X------?--M-----X--M---o-X-M-B-----XX-----X---?--X---XX--X------?----XX----XXo-o-X--------M----?-X-BB----o-X---?---Xo-----B-B-----------ME--X-------X-----X-----
-------------------------------?--------------------------------B----------------M-X-------?MB-X--X--M------------B-----------------o--------XXXo-X-----o-------o----------o-----X---------XX--X---M---v
---------B-------o------X----------XXB------------?------XX--------?--X-B-Bo------X-----X-------------?X-----------oX-------------o--M----------------Xo--------X-------?------X-B---------------X--oXXf
-X--o-----X--B-B-o------------B--------X--X-M---X------X--X-?-XB---------------o-M----M---?---------M-----------?--X-X---------M-------o----------------------B--X-X?-X-------?---XB--X---X--------oX--f
--X--------?---o----------?-------M-----X----XM-----X-----------o--?--X----MB------------------o--X----B-M-oXX------------M------------E--X----X-E---o--------o--X----------M-----X--X------Xo---------f
----X----X----B----o---------------X---o-o--X--M--------?o-------------oB------M---o-M----o-X-B------?--------oBX---M------------------M-o------MM---------Bo---o------MMB----B-----M-----X---M----?---f
---E------o-B----?--------MX-----o---X----------o------------------------?M-M----?-------M------X-----X-X----B----T----ooB-M---------------o------MX-----o--o-------------X----o------ooM-----------X--f
-XXX----X-----------Mo---E---M-------BX--?----?X--X--?--------------X----------o---o-M------o-------B?-XBoX----B--|-X-o--------?--------M--o---------B?----M----------?---XM----M-o-B------------------f
m--X--X----X----------o--X------B---------------o-----------------------o----X---------------o-X-X-----o----------X-----X-X--X---X-o--------------X------X--X----X-----------o----X-X--X--oX--XoX--X--XX
XXXXXXXXXXXXXXXXXXXXXXX-XXXX-XXXXXXXXXXXXXXXXXXXXXXXXXXXXXXXXXXXXXXXXXXXXXX-XXX-X-XX-X-XX--X-XXXXX-XXXXXXXXXXX-XX--XXXXXXXXXXX-XXXXXXXXXXXXXXXXXXXXXXXXXXXXXXXXXXXXXXXXXXXXXXXXXXXXXXXXXXXXXXXXXXXXXXXXX
