--------------------------------------------------------------------------------------------------------------------------------------------------------------------------------------------------------
--------------------------------------------------------------------------------------------------------------------------------------------------------------------------------------------------------
--------------------------------------------------------------------------------------------------------------------------------------------------------------------------------------------------------
---------------MX----M---X----XX----X--X?---------o---o-M-o----o----B---X--------M------oX--?--------M-----XB-----XBoo--?-XM-X?o-X----------o-------X-----------?X----------------------X--MB--MX-----?-
----X-------B----Moo---oB-------??--oBo--X-----B----o------------BBo--------X------X---X-----M--------X------oBo--o--X---X--------X--X---o---o---B-M----Xo-------------M-o?-o------oX-X--X---o-----o----
----B----X----o-----X-------------------------o-X--o------------X-------------o-X--X-----?X-----oM--------MX--o----------B-?--o-----?----------o------------------B--o-----B----X----o-------o--X-------
-o-o---------M--M------ooX--?X-------?---------X--o--------oM--M-X-----o-X-X--------?X-----X---------X-B?--X-----------M-------XB----------oo-------M-----------B-X-------X-MX-------B---B--?-M---o-----
-X?X-------o--X------o------------o---o-----Xo--M-----B---B--M--X-------M----o---X---X--oo-----X---B-o------------o--------X-?XX---X--M--M------X--------------------B-?----------------M----------?---v
--------?---------X------X-----X-B---B------------------X?--------B--------------o-X----------o--M-----X---------------oo--------XM-?------X------M---Xo------------M------o----------X-----?--Bo-----Xf
---X--X----Xo----o-----X----M------B-X----o-----X---XB--------?XM---B--?BX-?---MM-------X-----X-------X---o-Mo-------X-------XX---------X-B----------------------X-----X--X-B-----XXBXBo--X--o-----X---f
---X-----M----XB---X------?------------X---o-XM--B-X-----E----------BX-----------?X------o--X-----------o----------o----o-------?----Bo--------XX-------------o---?-o-------o--o-------B----X-----?----f
------X------------o---------M-o-X----X---o-X-------o?---X------------o-X-----?--------?----X----------M-------o--------------B---MX-----o---X--X-------------o---------?----X----------------XoX------f
-----------Mo--------To----X--M-----o---X--------------o-X----------------X----?-------------o-?X?--------?-X----------o-o-o----X---Xo-----o---X-M------X--oo------------T---------X--------------X---Xf
--M----XX------X----o|-X--X------X--o-----------?---M----------X---X-----X--X--------o--M-BX-----------oX--M-----X--XXX--o---B----------------o---EXXB------------oX----?|--------X--------X-oB--X--o-Bf
m------X--X-------X--X------------B---------X---------X------B-------------o-------------------X--X----o--------oX-XB--------------X--X-----------X---------X------------X--------X--B-X--X----X-BX---XX
XXXXXX--XXXXXXXXXX-XXXXXXX-XXXXXXXXXXXXXXXXXX-XXXXX-XXXXXXXX-X-XXXXXXX--XXXXXXXXXXXXXXXX-XXXX-XXXXXX-XXX-XXXXX-XXXXXX-XX-XXXXXXXXXXXXXXXXXXXXXXXXXXXXXXXXXXXXXXXXXXXXXXXXXXXXXXXXXXXXXXXXXXXXXXXXXXXXXXX
