--------------------------------------------------------------------------------------------------------------------------------------------------------------------------------------------------------
--------------------------------------------------------------------------------------------------------------------------------------------------------------------------------------------------------
--------------------------------------------------------------------------------------------------------------------------------------------------------------------------------------------------------
-M-----?-----X-X?-X-oM---M----M---------B-----o--B---M-Xo---------------------X-M--XX--BX------ooX----X--X--------B?---B--------------------o------oo--------BX------?-X----X---------?-----X?o---------
---X--------X----------o---M---X-?-----------------M----B--X-M--M--XB--??-----------------o--B-----X------Xo-------------M--XoM-o--X---------M----?---X---B-X---M---------o---M---------o--------X---BX-
----X-M---------?-o----------------X----X-X--o--X---------o---------X----B--XX?-Xo-o-----o----o---------XX-o-----B---o-o-------------o-X-X-----?--------MXB--X---X-X-----X-------B--X--o-------o----X---
-XX--------------o--M--M-----X------?---X---------------X-------------o----B----B-B----Bo-X-----o?----?---------o--MX-oo-X-------------------------BM------MM-o---M--------o----------------?o--?-------
------------X--------?----B-X-------------?--------?o-----BX?--X-X------??-------------------o-X----X----o?----o----o-----o------M--------X----------XM--X---?-?----oMM------X---XX-X-X----------------v
-------------?---o------M-----X---X-X-X------XMX-------X--E-----------------XX---------?------B--------------M----X------X----o-------X--X-----?-----------------X-------X-----X--o----??-X--B--oMX-M-Xf
----Mo--M-X----o-o----------------------X-X?----------X---MXX-XB-------M---?o---M---------X---------------MM---X---?------M-----X--B----oo--o--------------X----XXX----------B------------X----------B-f
------X----X-X-X----X---------------X---XX----?--B------o-----------?----?------------B-------XX----o--X---------B---X-?----B-------?-----M-----------oB--?---X---XM---------o--o-X----X---?X---?-----Xf
-X--------------X------X--------?-?--X---o--X-----B-------o---X---o--o?----B---?----------o---B--------------X--------------X?-------X-----B-------X-B-------B--o---?---M--------Xo-X--------o---------f
---------o-M--X--o-X------o----------------X--o------X-----M-----XX----X---------Xo-B-X-----B---X-X-oo--------M---B-----oM-------X--o-M-XM---------------?-B-------------BX-----B--X----?X-------------f
---o-----o--ooX--------X---?X-o----------?--??----o-----------------------X-----o--------o---------XB---Bo-X---BM-----o------o------X-------------o---o---------M--?-------oX--X----X-----X--XX-o-B----f
m--X---------X-X---X-------------B--------B-----o--------X------------------o---X-------B------X--------------X--------------------o-X-----X-X---XXoBB---X--o----X-----B----X-----X-X--X-X----Xo----X--X
XXXXXXX-XXXXXXXXXX--XXX--XXXXXX-XXXXXXXXXXXX--XXXX-XXXXXXX-XXXXXXXXXXXXXXXXXXXXXXXXXXXXXXXXXXXXXXXXXXXXXXXXXXXXXXXXXXXXX--XXXXXXXXXXXXXXXXXXXXXXXXXXXXXXXXXXXXXXXXXXXXXXXXXXXXXXXXXXXXXXXXXXXXXXXXXXXXXX
