--------------------------------------------------------------------------------------------------------------------------------------------------------------------------------------------------------
--------------------------------------------------------------------------------------------------------------------------------------------------------------------------------------------------------
--------------------------------------------------------------------------------------------------------------------------------------------------------------------------------------------------------
-?----------?--o---B--X----------X---------?--M--MoEo-MM-----------o-------------------o----------X----X-B------X------------X-BX--MB------------------------?----X---M-------B-M---??-------X----------
--B---M-X----B--------Xo--------oo-------X---------Xo---o?-------X----------X--X------X-?-X--B-------X-o--?--------------?-B-----M----X-o-X----------------?--X---o----?-XXo-----------X-XoB------XM-M--
---------M--------?o?--o-M--------X-----------oBXX---------M---X-----------------M-o?------M------X-----M--X-?---o---------o-X------?------------X--------------o----o---------X----?-M-----------------
-M---X------X----E-------------------------------X-------M----B--M---------BX--X--o-----XM---XX------------------------X-X--X-------------------------------o----X-------?----X-----------------------M-
---X--M-B-o------X---o------?--M---X---E--X--------?-------X-------------------Bo--?--------X-----X--M---X-X?-----X-o------X------B-----------o----X--o-o-o--o--------oX---XM------o--------X--M-o-----v
-??-----------o-----------------oM-----X---------o-----X--X---?--E-M-------?-X----------B-o---B----o---XX-------B---------X-----Xoo----?-X-------X-----------------X------o---M--------B?-X--o--o------f
------X----X-------o---??-----?------o--o--X---------------------M--X--?------------o-oX----o-----Xo--M-X-----M-o----X------X-----------o--Xo?--M----------o----BX-------------oMB---------o----X--o---f
---------XXB---Eo---X--------------MX-----M---------o-B--------X--X-------o--------------X-o---X-M-------M-XX-----------o-------------o-----------X---o-B-B---X-o-----o----------o--BX---X?----X-B-----f
-------?X------?-oX--X--EX-B--ooB----------------------B-------------M--X--B-------X-o?X-------------------------?o-----------X?-----------M--oX--B----X----?M---M---o-MoMMBXX--------X-X-----X--------f
-X---------------------oX--X-BX-------------o--------B---X--X----X-----Xo-----?------------o----X--B-BM---BBX------oB---o---BM-------XB------X--------X-M-----oM---M---------B--BB----oX-X---X--?------f
----Mo-------o----XX?-------M---XX-------o-------M----o----?XX-------o-o------------------M---------B------E---B-?--X-----B-----------B----X-X----B-XM-----------X-------o--X-X-----B-------?-X---B-Xo-f
m--------------------X----------X---X---o---------------------X-o--------o-------X----X--------X---------X-X-------B-----X-X---o--Bo--o-----o--o--X------B-----X-----X---oX-X--------B-X-Bo---X------oBX
XXX-XXXXXXXXX-XXXXXXXXXXXXXXXXX-XXXXXXXXXXXXXX--XXXXXXXXXXXXXX-XXXX--XXXXXXXXXXXXXX-XXXXXX-XXX-XXXXXXXXX-XXX-XXXXXXXXXXXXX-XXXXXXXXXXXXXXXXXXXXXXXXXXXXXXXXXXXXXXXXXXXXXXXXXXXXXXXXXXXXXXXXXXXXXXXXXXXXX
