--------------------------------------------------------------------------------------------------------------------------------------------------------------------------------------------------------
--------------------------------------------------------------------------------------------------------------------------------------------------------------------------------------------------------
--------------------------------------------------------------------------------------------------------------------------------------------------------------------------------------------------------
--------M--?---X-M-?-------X--------XX-X---?-X---?o-o----X-o---------X-----o--o---------Xo--X--------?---o-X------------------------B-----?----B-------------B-------o----------------------B?--------o-
--X-X----o---o-X------Xo-----X---?-----------------Xo---o-----oo----------X----XM--Xo--o----oX---------------o------XXB--?-XX?-oX--o--XXo-------X-------------------X-----M-B?-------X---X-M-----M---B--
--------M-------?----------o---X--X------?X-X-oX-------------B--o--XX-oo-o----o--Boo-----X--------X----X-?--B--------------o--------------X--B---X-------X-X--X----X-X-E------------?-oB------?o--?E----
--?---------?-----MB----o?-------------o---------Xo-----Xo-------X-o-B------XX----B----------X---------X--------o--X?--------o----M---?-----?------Xo-----o------X----BX-X----X-?o-----------------M--M-
---X---------o-----o--------?X-X?o?--X--------X------------------X----?-----X------------?---o---BX--o------?----M---X?----------------X--o-----o-o-----B-o--?--------o-M--X?B--------------X----o-----v
-XXo----MB-------------M-------------B?-----------o--M--MX---------X?-----o------o-----o------B-X------o-----B----o----o--------B-----o----X---------M-o------B?----M-----o-----X------B-----oM-----?-Xf
------------B-o---------?----X------o----?-X----X-----?-----?----M-----?-----X--MX---X-X-o---X------M---o-------o----XM--------------B--o-?--?--M------o--XX-------------o--B---B-------X--M------?----f
---------X-X--------------?--o--------X-----------o----------X------X---o-X---------X------------------Xo---X---------------?--------------------B--o-o-B-B---X-o-o-------M---X----?BXBX------------XX?f
--X------------------X---------oX-??-X---MB----M---B---MM-Xo---o---------------X-------M-?----o---X-------M--X-X--M----M--M----o---------M-----X----X--X-----------B---?-----Xo--X--X---X----o---------f
-X---------M--o-------Xo---X---X----------------?---X---------o---?o------M--?-----X-M-----X----M--?o-------------------o-----o-----XXB-----X----?---M--M--B---X------------?---B-----M---------?X-----f
--?-M---------------o?----X--X-------XMX---o-----M---------oX-------oM-o--------B-----M---oBo----------X-M-----o-?--X-o---B?-BX---X----X---XE-----B-------?-----X--------o-------------------oX----?-o-f
m--------------X------------------X-X---o------------------X---o-----------X----XB--X----------X-B-X--------X-X----------X----X---Bo--oX----X--X--X---X----X-----o--------B-oX---X-XX--X-B-X--X-----o-XX
XXXXXXXX--XXXXXXXXXXXXXXX-XXXXXXXXX-XXXXXXXXXXX-XXXXXXXXXXXXXXXXXXXXX-XXXXXXXX--XXXXX-XXXXXXXXX-XXXX-XXXXXXXXXXXXXXXXX-XXX-X---XXXXXXXXXXXXXXXXXXXXXXXXXXXXXXXXXXXXXXXXXXXXXXXXXXXXXXXXXXXXXXXXXXXXXXXXX
