--------------------------------------------------------------------------------------------------------------------------------------------------------------------------------------------------------
--------------------------------------------------------------------------------------------------------------------------------------------------------------------------------------------------------
--------------------------------------------------------------------------------------------------------------------------------------------------------------------------------------------------------
---------o-----oX-----M---MM--XM--------o----M--?XB-X--Xo-X-----MoM---X-----XB---B-----o---?---E---X--------B--------EBB-X-------X-X-M---M--M-------------X--XX--o--o------------?----------B----oMXX---
-Bo-------o------M--?-----------o?--?-----??--B----------o----X----------?-----X------?o-------X---B---o--X-----?-X-XX------X-----------------X----oB------B---------X-?-M---?----oB-----------------B--
-----?B-Xo---X-----------------M---------------------X----X--------oX---------o----------M-----------M-----XX--------X-M----o--M------?----------X--o---X-----Xo--BX-----------oM-X-o-XX-M---------XX---
----------?-M---X----o----X-----B--B--X-X--X--B-------------X----M-o----o--?B----------o------B-----------o----------------------------o----X--X-o-----------X----B--------X----------------------------
----?-------------X---X-----M--X-------------X---------?oM-X------?----------o---M-X----M-?M-------oX----------o-----------XX?------------o--------?B-----------o--------X--M-------o-?--------X--X-o-?v
--------------o---B---X--B-----------B--------?----M--------B------X--B--?------------M------------X--------B-------M----o---------------------------X?----XX-----------M--------oXE---X-------X-X-----f
----M----?-X-M---o---X--X--X--XX?----X-o-B-------o-------------?----o----------o----o------B---X----------------------E-o-----M-XM------M-?-o-X--X------XX---o------XX---M-o-------X--X---X------------f
-oX---X-------o-------X---?------X----X-------M---------B-----------X--X--o-----X-X-----X------------X-X----------M---?--?---------XEX------X----------o------X---?-------------o----X-XM----o-X-------f
--XX-M------?---?---o-------X---M-----------o----------------X--------------------o----M----XX--------X---B-------------------?---X-?----o-X-----oo-M---XX-o-------o-o--?X--X-o-----M-----B-----------Xf
----------?---o---X----M---X--X------?-----M---Bo--?-X--MXT-X-MXMM-X-o---B-------B-----------o-?--X--MX---X--B---M-?-o---------------?------------X--X---o----X?----------X-X-oMBX---------M-X--XX-----f
--X-?---X---X--X-?---X-----B-o-----?----------------------|----------X-o-------B-----B----------X------M-o-M--------X----E------------------??X-------o---X-------o---?M-o--------o---Xo-----XXX-oM-X--f
m-----XX---XX--------B-XX--------B---X----X------o----X-X-X---X------------X--X-----X---B------X--------------------B----X-Bo-----Xo-X--------B---X--------------o---------------X----X-------X----XX-XX
XXXXXXXX-XXXX--XXXXXXXXXXXXXXXXX-XXXXXXXXXXX-XXXXX-XXXXXXXXXXX-X-XXXXXXXXXXXXXX-XXXXXXXXXXX-XXXXXXXXXX-XXXXXX-X-XXXXXXXXXXXXXXXXXXXXXXXXXXXXXXXXXXXXXXXXXXXXXXXXXXXXXXXXXXXXXXXXXXXXXXXXXXXXXXXXXXXXXXXX
