--------------------------------------------------------------------------------------------------------------------------------------------------------------------------------------------------------
--------------------------------------------------------------------------------------------------------------------------------------------------------------------------------------------------------
--------------------------------------------------------------------------------------------------------------------------------------------------------------------------------------------------------
------X---------o----M---X---XXX--XM--------------M?--o-o---B--o-----------------B-----BoX------Xo---M-----X------------?-XM---o-?-o--------o-------------------?X-----o----------M-----M--MB--XX---X---
----X-------B-B--MXo---o--------B----B---X----------M---------o--BXo-o------o-o-X-B-o----------X------?--------o--X-BX----------------XX-o-X-o------?---XX---------?------MMo-------X-?--B---------oE---
---------X----------XM---------B----X---------oMX------?-X------X--X-Bo----B--o-X--X---o---X--o--M----------B----------X-BMX-----XX-?X-----------M----?-------X--X---o-------o---X-----------XX-X---M---
-o-o---------?--X------ooXX-?X------X---X---------M--------o-------------X-----?---------X--------X--XX-?--X--------X--------X--B-----------?------------------M?-----o-?---MX-------BoX----X-X---X--o--
--o--------X--XX-------o--------M-----o----M-o--M----X--X-Bo-M-----------X---o-------X--o-------X--Xoo-------M-M---------o-?--?----X-----Xo--?o-X---B-o------------B-Bo------------o----M--------X--X-Ev
----B-X-?---------X------X-------B---B---X---------------------------------------oM--------X--o-XM-----X----------------o----------X-X-o-X-----------o-M----------o-M------------o--------XX----o-----Xf
------X-----o---?------X------------------X-----X-X-XB--??----?XM--------X-o---o--------X--X--------------B-----?----X--------X---------M-B-------------o--------X------M-X-X--X-----X-o-X------XX-X---f
---------M----X----X-------------------X---o-XB----X------o---------Boo----------?X--M---o--X-----o-----o----------o----o---------?------------X-o----------------M-----------Xo------M-----X----o?----f
------X-----o-------XX-----------X-o------o-----X---------X-------------X----M--------------X---------X---?----o--o----------------XX--M-o--------------M-o--X------?--X?M?--X--X--MM-------B?XoX----?-f
---------------------X-X---XX-------o--B----------------oX-Mo------X--X--------?---?-----B----MM------------X----------o-o------X??--------o-------X-----?-?----------------o----B----XXX--X----------Xf
-----M----XM---X--M-o-MX--M----X----o------------------o-------XM-----------X--------o--Moo------X-----oBX----------XXX------BX------X----o-M---?--X---------B-B---------------------------o-oB--X--B?-f
m------X-------------------B-----XB-------------------X------B------------X------B----------------o---------X-X--X-X----o------------XX-----------X---------X--------------B-X----X----X--X------BXX--BX
XXXXXXXXXXXXXXXXXXXX--XXXXXXXXXXXXXXXXXXXXXXXXXXXXXX-XXXX--XXXXX-XXXXXXXXXXXXXXXXXX-XXXXXXXXXXXX--XXXXXXX--XXXXX-XXX-XXXX--XXXXXXXXXXXXXXXXXXXXXXXXXXXXXXXXXXXXXXXXXXXXXXXXXXXXXXXXXXXXXXXXXXXXXXXXXXXXX
