--------------------------------------------------------------------------------------------------------------------------------------------------------------------------------------------------------
--------------------------------------------------------------------------------------------------------------------------------------------------------------------------------------------------------
--------------------------------------------------------------------------------------------------------------------------------------------------------------------------------------------------------
---------------------M--oX---------o----X--------MX---M---X--oo-------X-X----?-?--XX--B-------X-----?-------X-------XM-o------X-B---?--B-XXo------X--B------------------B--X---oM-M----B-------o-o------
---------BM---B-X-----o-B--X----o-MX?MB------------XX---?X-----------X-oX-----------o-X-----X-----X----X-B?--M-M------?-B-o----o------------o---X---XB-X--X--X-o--------oo----M----X------------M--X----
------XB---o---?-------X-M----X---------o----o?-MM-------------X--o?------o--X?o---?---------o-?---X-B-X---o--------M-----o--M---Mo--------X--?--MM-------B--X------?-------X-----X-X--o----?--------Bo-
--BX------X-----------X---E-oo--M--X---o-------------------?---------------------X-----XM----B----------o-X-------?--X---?---------X-----------?---------X-M---------o---------oB------XX------o-B------
-----o--------M-X------ooXX-o----?--X?----o----------X---------B--?--X-----X-------o------M----o---E--X------------o------oMM-X--------M--------XM--X-Mo--------X-----o----B----------o-----XX-------?-v
------------------B-o----------------------X-M-------Boo-----X--------X-----Xo--------------oMX----X-----------o--X-XX-------X-----------X-----o---XX--X----o------X---oX---o--X-M--B----BB-------o----f
--oo-?---------o----X----Xo--?-----oB--X---------B?-----------------X--------------X---oo------o---------------X------X----X--X?----------o--o-----------------B--M-o-o---Bo--?-----------XB-----MX-XMBf
-B----X---o----X------------------B-----------X-------M--------E-Xo-o------------M---o---X?--------??-----o-X------B?--?---X-----o--X-X------E--Xo-?oX---------------o-----------B-----o------X--------f
-----X----X-----X-M-BM--Xo-M--o--B-o--M?-----X--B---M------X---XX------?-X--o---------XM---oX------------------X------------?-o---X--------o-X------X--o------M---o--o---------o-o---------------------f
----MX---B-------------X-----T------o----o----o--X----o-Xo----X--X---------MB--------B-----------B-XM-----B-------X-o----o------T-----X---------X---------X-------o-------X---?o-----B-o-----XX--X-----f
-------o------X?-M-?-X-X-----|-o---------------------?---o--X--Xo-X-----XB------XooX-------X--X---------?M----oMM----------o----|-------M--?------M--Xo----X-----X----MB--oo--------X---XX------X-X----f
m-X-X-B-----------------X----X--X----X-----o----------o--X-------o----o------------X-------------X---XX--------------XX---------X---oo---X----------o---ooBX-B---oo--------------o--X----oo--X--X-B---XX
XXXX-XXXXXXXXXXXXXXX-XXXXXXXXXXXXXXXXXXXXXXXXXXXX--XXXXXXXXXXXXXXX-XXXXXX-XXXXX-XXXX-XXXXXXXXX-X--XXXXXXXX--XXXXX-XXXXX-XXXXXXX-XXXXXXXXXXXXXXXXXXXXXXXXXXXXXXXXXXXXXXXXXXXXXXXXXXXXXXXXXXXXXXXXXXXXXXXX
