--------------------------------------------------------------------------------------------------------------------------------------------------------------------------------------------------------
--------------------------------------------------------------------------------------------------------------------------------------------------------------------------------------------------------
--------------------------------------------------------------------------------------------------------------------------------------------------------------------------------------------------------
--X--XX-----o-Bo-----M-oBo-----o--MM--oM--X-------X?--X-------o-o------o-o---o---M-X--X-X-----B-oB--------M--o-----o---o-------MX---B-----M-----o----XX--XM-----X------?------B-----------XX---------B--
--------X-X----------------X-X-------------X----o---M-o---X---oB-----Xo---M-------XX-o--X----Xo?------?B-----X--------XX-o---X-------------B---X-o-----B----------------X--X---Xo---M---X-------XXo---B-
--?-XB-----X------BoB--X-X-----M----X?---X-------------o---?M------B----o---X-------o-----X-----B------X----------o-M----o---o--BB--X---X----------------?--X----------o----X-----X-----------X----Mo---
--------X-B-----X-----X------X---B------?-M-oo-XX----X--------MB----X---------o-XX----X-M-----o-oX--o-X----?-X-------------X---X-----?---B--?----E-MX-----oXo--------B-------XoX-------EB---------------
---o-----o---o-----o---o--X---X--X-?-------XB---XXM--------X---------o-oo---o------oo-----XX----------X-------oX--o-o--BX----X--X----------------M------Xo----XX--M---?M-o------B--?---X----oBXoo-X-X--v
--M--------o----o------o-X----BXX-------BX-----------------o-o-M---oX--B-B----------Xo?o----X-----X-XX-----oo---o-----o----B---------------o---?---o--------------------o---X--M----------X-----------Mf
------X----------oooXoM------?-----X--------o-X-X-ooB---oX------M-----------------oo---------o?--o----X--o-----X-----o------o-M--------X-----B---Xo-o--------o--M?---M-----B-X---o-X?------X----XXB----f
--------X---o------o---o-o-----M-B-----------o------------X-X-------o-X---X-oBo-----------------o------o-X--------------BX-o---X--?------XB-X----o-----X--o-------Xo----o---?X----?--B--X-X-----X--oX--f
--X-X-o---oBXX--------o------------oX--oXX----B--o--M-oX-B--X---X-oM---X-?o---------o-M-X--------------o----------B-------M-----X------X-------B--------------o---------B------o---X------B---o--------f
-o-----o--o----X--B-X--?---M--X-Xo----X--o-----------o-----o-X------X--X---o--?--------oB-M--oX-----Bo------X-X-?-------o-----T----oX-XXoXX--B--?-o-MMXo-----o----X?--o--------X-----XX----X----XB--T--f
--o---------B---------------o---B-----o--------?X-----------XX--X--?X------------------X------o-X--o--B----X-X-----------?-Bo-|X---B-------X----------X--BXX-o-X-B--o------------X-----XoB--------XB|X-f
m--o---X--Xo--X----------------X----------X-X---X----X---X-------o-------o-BX------o----X------------X-----X---------B--------X----XX-X-B--oo-------oX---X-X--X-o---X------X--X----B---o-B-B--XX--XXX-XX
XXXXXXXXX--XXXXXXX-XXXXXXXXXXXXXXXXXXXXXXXXXXX-XXXXXXXXXXX-XXXXXXXX-XXXXXXXXXXXXX-XXXXXXXXX-XXXXX-XX-XXXXXXXXXXXXXXX-XXXX-XXXXXXXXXXXXXXXXXXXXXXXXXXXXXXXXXXXXXXXXXXXXXXXXXXXXXXXXXXXXXXXXXXXXXXXXXXXXXX
