--------------------------------------------------------------------------------------------------------------------------------------------------------------------------------------------------------
--------------------------------------------------------------------------------------------------------------------------------------------------------------------------------------------------------
--------------------------------------------------------------------------------------------------------------------------------------------------------------------------------------------------------
---------X--------X-------------oXX---o---B----------?--------?----Bo---?--------X----M--oX-------?-?-------M-----o--X---------B--X-------oX---oX--------M-----------------M-----X---oM-oX-X-M-XX-------
--X------B----XB-?---------Xo------------------o--------X---M-----M--B----X--X-----o---------M---------oX--------------------X-BX---X-------M-----o-X--B------o--oX-----?-------Xo-X---o------X--M------
------o------M-B---o-X---?----------o-o------M--X---?---o-----MX?---M-----------B----MX---XM--B-------B--X-X--X-----X---B-X-------M--o------------oX-o----X-?-B-----------?o-X----M-------o--X-X--X-----
-o---o-----X--?-X-M-Xo-X----o?------------------o------o--------------------------------------------XB-o--M-----MM--XX------M----------X---------o--------------------------oX-o-----?oo----Xo---X------
--o--Xo--X--X---------X-----------X-------?------X---------------MXo-------M-----------XX-------------------B---------o-----------X--X-o---X------------o-?------------XB------o--BX----?-?---X---X-X--v
------X------------X-M-----X----M-----------oM--o--o---?-o-M-----------?----------------X----B-X--M----X-X--Xo--M--------B------------o--XB----o------------Xo--o----X--o--X------X--------X------o--Xof
--------XB----?-----------?--?----X------------X-------------X-----BX----M-------o--X------M--Xo------------------X------X---X--?----?----o-o-X--oX------oX-------o-------M-B-?-------------BX---------f
-----X-X---o---o--------X-----?----------o---o----------o-X---o--X--------o-----Mo-?--M--B---?---------B---o----------M-------X---oX----o----o------M--XM----------M--o-?--?-----o--o--Bo---X-??---oMX-f
---XM---------o---?M--M-----X-----o-o--X------M-----------o-o-----X----------------------------X----X-----------?---X---------------X----B--X--B--M--X----Bo-----?---o-------o-----X-B--X-------------Xf
------XM----M---------------------oo------------o------------------o------------B---------------------------X-----M--------o-X-B-o------MX---------M--------M--?----X-o--------o-----o------XX---MX----f
-o---o----------X----o--?X----------------------X------------o-X-X---X-----o-X----X----B-M-------X--?---o--X-B----------?-X---------XX---------BX---oX----------B-----X?---X-o----o---X-X----X-----?-XXf
m--B----------X-------X-----o-X-----------B-----------------------------------X-----X-X-----------o--o--------------X----------o--o--o-XX--o---o-BXB---B-B-------B-oX-----X---o-o-o--oX-----XXo-Xo---X-X
XXXXX-XXXXX-XXXXXX-XXXXXX---XXX-XXXXXX-XXXXXXXXXXXXXXXXXXXXXXXXXXXXXXXX-XX-XX-XX-XX-XXXXX-XX-XXXX-XX-XXXXXXXXXXXXX-X-XXXXXXXXXXXXXXXXXXXXXXXXXXXXXXXXXXXXXXXXXXXXXXXXXXXXXXXXXXXXXXXXXXXXXXXXXXXXXXXXXXX
