--------------------------------------------------------------------------------------------------------------------------------------------------------------------------------------------------------
--------------------------------------------------------------------------------------------------------------------------------------------------------------------------------------------------------
--------------------------------------------------------------------------------------------------------------------------------------------------------------------------------------------------------
-------?-------------o-B-X------o----?----------XM-X---X?o-------oB---X-o-------------?--o------------XMX----X-------X-----------------------X------XXM-o--?-----X-----------?----X---o--X-----------oM-
-------------B----------X------?------------?oo-----------M--X--?---X-X---X------------------M---------------X-----X-------?--?X--------X-------------------M-----M-B----------X------------o-?---------
-?--------B------------B---X----o-oXB--X-X----BX---o---o----o---------------o----------------------------X--------X---------------X-Xoo-X?---X--o-Xo---oo----o-------X-oXB-M-----o-oo----------X--X---o-
----o---------------X-X-------o----X---oX-------X-----?---------X------X-XX------------o---X-M-M----o----------XMM----------oX--X---X----------------XX--Xo---o--------oo---------X--X----oXX---o-----X-
-------X?----?----------------B---------------X-----------M--o----o---B-------?----B-------X---------B--B-------------o-----X-XX-o-------X-----?-----X-------o----M-XM---M--X--XB-------M----X---------v
----X----B-------------X------------X---------oXooX--------M----?o-M-----o-o----------o-?---M-------?-X------------M--X---M----o-o-----oo--X----o-X-B-----------o-----X----Xo-B----o--M-----------X---of
-----M-o---M-------M--B-----M-B----X--------X----------------M------------------?--------X------X--------------X-----X--o-------X---o----------o-X-----XX--XM--------o-X-------X---X---X-o-B----XX-B---f
--M-----?-----------o----------X--B----B-----o--o-----o--------o----X-M-X--?-oX--Xo-X---X--X-----------M-o-------X-M--?-----------XX-----B?---M---o----------X-o----X----B----------oo--------------MX-f
----M-----------XX----X----?------------------------X------o--X---M---------X---?------------------B-----X------?---------XX-M-Xo----B---------B-X-----B---Mo-----MB--X---B-X---?--------Mo--XB--o?----f
-------------M-X--X---------B--MX--------B------?--XX---X-X-o-------------?---M--o-----X--oo---o--o---------M-B-------o----o---X-oB--BX-X-X-------?-X----o----M----X-----M--------B---X------------X-X-f
-------X--o----------oB-B----------Xoo-----------X------------o----XMo------------o--BX-------M---------B------X--?-------X------------?--oB-?-----M--?-MX--X---B-X---------X?--B---X-X-----X------X-o-f
m--------X---X---X------X-----------X---------oX----------------X----------oB------------X-Xo--------o---------------------o--------X-----------X-------------X-----------o-----X---ooXB----X--o-X-X--XX
XXXX-XX-XXXXX-X-XXXXXXXXXX-XXXXXXXXXXXXXX-X--XXXXXX-XX-XXXXXXXXXX-XXXXXXXXXXXXXXX-XXXXXXXXXXXXXXXX-XXXXXXXX---XXXXXXX-XXXX-XXXXXXXXXXXXXXXXXXXXXXXXXXXXXXXXXXXXXXXXXXXXXXXXXXXXXXXXXXXXXXXXXXXXXXXXXXXXX
