--------------------------------------------------------------------------------------------------------------------------------------------------------------------------------------------------------
--------------------------------------------------------------------------------------------------------------------------------------------------------------------------------------------------------
--------------------------------------------------------------------------------------------------------------------------------------------------------------------------------------------------------
------X-o----X------------------X-------X-?------M?---o------M-----XX------------B------M-oM-----X-----------M-------M---X--o---XX----M---M----o---B---XB------o--Bo---X------o---oB---B------B---M-o---
--------o---X-----------BB-X---------B------?X-X----B---------M----o-----M-XM---X----o---X-------o-?-----B-X------?-----X-----o----M---M---M----------------X--------------X-----M--o-X---B-X-------o-M-
-X-----o-o---o-----X-?-------B--oX--B---------MB--o-------B-o--o--o---X------??---o---?B-o--MX------------o----?-----------X-?-B-?---X------o--?-X-?M----o-Xo---------o--o--------X---X---B------oXM----
-----?---X?-----X-----o---X-------M--X-----------------------o-X---Bo------X---o-B------------o--------X---------o------X-----B------B---XX-E---M-----o--o-B-oo-?--BMM-----------M------------X-------M-
--M----o---o-----B--o---M-----------------------------o----X--o------o-X----X--o-----?--oX----X----X?-------XoB-----X?---o--------o---------B---------------------X-------X-------o------?-------------v
--------BM----B--o-------------B---M----XXoo-B---o-X------o----------------------------M--------o-----------------X------X?---------------o-X--B-------?-X---o-------X--------X-------Mo--BoXX-M-------f
---B------M----o---X---M-------BX----XX----------X-------X-------o--------------Bo?------B---oM----------BX---M----o---X----o-------X-E-?----M-------X-----------?-----Xo-----o---oo------------o-o----f
-X-------------------------------?------B------M?-----B--------X------X---X-------------B-o------X-o-o--B-X-------XX-X----oMBM-X---B--M--------------------oo------o--?-X----o--------------X---oX--o?-f
--------X--o-o----o---------o---------------M----o?---------oX---B-----XMo------X----M-o-----X----M-o-----------Mo---oooXX----M--XX-E----o-X-----X-MXX--Mo----B--------B---M---o-----------X-X-----B---f
-----XX-------M------M--X?------X-X-B-oX-------B----------X-----o---X-o------B---Boo---X-------X--------------?----X----------------X--T-------?------------oX-o------B---------------X-X-X------BoXM-of
--MXM------------o-----M------B----------BM---X-o-----?X-X----oooXX---o--B--------o-X---X-X-Xo--o----M----?------M--------oX----------o|----X----BM-------B-----------B---oo---X----B-o?--B-X--------X-f
m-------X------BX---o-----B-o------X--B-o---X-X----------o------------X--------------------o----o-------------XX-----X----XB---X-------X-----------Xooo------------X-----X----------------X-----X-X--X-X
XXXXXXXXXXXX-XXX-XXXXXXXXXXXXXXXXXXXXXXXXXXXXXXXXXXXXXXXXXXXXXXXXXX--XXXXXXXXX--XXXXXX-XXXXXXXXXXXXXXXXXXX-XXXXXXXXXXX-XXXXXXXXXXXXXXXXXXXXXXXXXXXXXXXXXXXXXXXXXXXXXXXXXXXXXXXXXXXXXXXXXXXXXXXXXXXXXXXXX
