--------------------------------------------------------------------------------------------------------------------------------------------------------------------------------------------------------
--------------------------------------------------------------------------------------------------------------------------------------------------------------------------------------------------------
--------------------------------------------------------------------------------------------------------------------------------------------------------------------------------------------------------
----------------------o-----MXX-XX----------------------------?X-----------?-----?M---X-----?--------X-MX--------X--------?------XBB----M---o--?---X-o----o-----------------------??--X-B----------B----
---X----o--?Xo------X--------X------oX------------------?-------B---?-------o------------------?----o-----?-----------X----M-------o----------------------------X---B---XX------------------X-----------
-oM-B--------X?--------o----------X------B---X-----X----------?--------o-----o---X--------o--X---?--------------X-?X------------?B-----?Xo--o------------?-X--X-Xoo-B----XX?---X----------o---------X---
---X--o--------X--M-?-----M-o--------o--o-----------M---X-------M--o--B--------------------B------o-------------o---------o--------XBB------oo---M--o--------------M--------------M---MX--------X--?X---
----o---M--B---------------M-------o---o----o----------------X?-----BX------?---------X--X------XX-----oo-----o--------XoM-----?-----B-o------MoE-------------------------?---------X-----X------o-----v
--X-X------B-M-------M?------?--X---?X------B--M-----X-----X---B------X-------o-------------------X-B----X------B----------o--------o-----------M--------?----------o-o-------------B----?--X--o-----X-f
---B----o----------------B-X------X-----------------------B---X---o--o-----------------------XB----X--------------o--o--o--------??----o--o--?------X--o---oM----X----o-o--X----MX-X------X----X-------f
-MX-B?----o---------X-------X-----o----X-------o-?-------o--?----------X------M------------X?--------MX--X------oX--Bo----------E-------o----------o-----o--------o----o------M--B--X---------X-----X--f
------?--------M--MM---?--o-oB---------------?-------o---------------Xo----------?---------------------------X----o-----o-------MX-----Bo---MMMB----------X-X---XX-o--------------oM--o-B---Xo--------Mf
--------o------------------?-------------------X-oX-------------o----------X-B-------?-M----o-o----------------------------------X--------------?o------oT-M---B----X-----XX--X-------X---B--X---X-----f
-------------?---X-o----B---X---oM--------------o--X---XM-------o----?-------------o------------o-?------B-oMB--oo---------oo-----o---------------X------|---X-----Xo--?---X----o-X--X--?-------X------f
m----o---oo--------o-X--X--X--------------------------------X-----X-------X--------o------X---------------B------X--XX-X-------B--X-X--o------X---X----o-X-----B---Xo------------o-BX-----X-----X-B--oXX
XXXXXX-X-XXXXXXXXXXXXXXXXXXXXXXXXXXXXXXXXXXX-XXXXXXXXXXX-XXXXXXXXX-XXXXXXX-XXXXX-XXXXX-XX-XXXXXXXXXXXXXXXXXXXXXXXXXXXXXXXXXXXXXXXXXXXXXXXXXXXXXXXXXXXXXXXXXXXXXXXXXXXXXXXXXXXXXXXXXXXXXXXXXXXXXXXXXXXXXX
