--------------------------------------------------------------------------------------------------------------------------------------------------------------------------------------------------------
--------------------------------------------------------------------------------------------------------------------------------------------------------------------------------------------------------
--------------------------------------------------------------------------------------------------------------------------------------------------------------------------------------------------------
----BB----o------------o---M-----------o-----------B----o---------X---X-X-o---------XX--X-----M-?o---X-XX----------BB--o-----------------------------o---?-o-B--?M-----o------X-----------oM-B?-----M---
-----------X----------------M-----B--X-----M----X-----MX-------------------B-?------o----XX-------X------------X------X----M-M--M--------X-o-M--B-X-M-oo----o---------?--------X-----?--X---------------
---X------X----o--X-------M----?---?B--X-?--?--o--X------o--------X--??-M-----MBB--X-------X--?--X-B-?----o-----BM-----X-o----o--X-X---o---------------X---o-oX?M-o-M------?--B------------oX---X--o----
------------------X----BX-------B---------X--X---------------------------?------------------X--oX------X---X--XM---X----?------B-o?---M------X-ooo----------------------------------?--------ooX-oMoB---
----oX-----M-o-----------------B--X---------o----X-----?-----X--------------X?-------X--------Xo--?X----MM----------M-------?------X-----o----------------o----X-------X------?-o-------X-------M---Xo-v
---M------------B---B-----------Xo-------X--X-------------------M---M-o--o------------------------------------X--------X---------?---Mo----X-----X-M-B----------oB-o---X---------X--?B-X---X------o?---f
-----B--X--oo-B----B--------B-------oMM---------B---X-o---------E---------B-X-?----B---M--------XX------------o-----------------------X-oX?X-----o----------B-------oM------------o--------------X----Xf
------------o--o----?-------X---------------X----o--------------M-?o---o-?----------------??M--X--o-B-------------X-------?o-X-o--X-----o-----o-----?-------------o----o-B-o---X-?-X-o------X------o---f
---X-----X----X--?--------------o-X-?--o--------X---o-----BBB------------------------o-----------o-o--------X-B-----------------------X---?-B--------X-X-o-X------o---?---B----------------M---X---o---f
---------------------M----------------X----------B-----------------X-BoX----X-------?--Bo-----------B------X------?----------XX---X-o---X-------o-------------------X--?----o---X---o-X--------o-B-----f
---o-M-------------o--M-------o---X----B--o-----------XX----o-------B---------oX-?----?----------?--X---------B------------------B---------?------------------MMM-X-------o----EB----B----M-XXX-?X----Xf
m------------BX--X------X--B--X-------------------------B-----X-XX----o--o----------X----------------------------XX---X-----------o------------B-------o---X-----------oX-----XB---X-o--o---X------oo-XX
XXXXXXXXXX-XXXXXXXXXXXXXXXXXXXXXXXXXXXXXXXXXXXX-XXXXXX-XXXXXXX--XX-XXXXXXXXXXXXXX-X-XXXXXXXXXXXXXXXXXXXXXXXXXX-XXXX-XX-XX-XXXXXXXXXXXXXXXXXXXXXXXXXXXXXXXXXXXXXXXXXXXXXXXXXXXXXXXXXXXXXXXXXXXXXXXXXXXXXX
