--------------------------------------------------------------------------------------------------------------------------------------------------------------------------------------------------------
--------------------------------------------------------------------------------------------------------------------------------------------------------------------------------------------------------
--------------------------------------------------------------------------------------------------------------------------------------------------------------------------------------------------------
-X---o-?--X--M-----X----------------------X-M------X--B---?----X---o-----X------E------X-X--X--o-----X?-X--X---X---------?---?---XX---------X--X------oX-----XB-------------XX----------o---oB--?---?o--
-----------X-----M-X----X-------X-XX-----?o----X--X----X----oXX--?---X----X----X?oo-o-----B--------------M-X-----M---o-------------X----X--Xo-----X----o--?----o--X--------------X---?------------?-----
-M-------?-----o--X------E--Mo----------------------X---B------?--X-o---X--X--------X----X-B--MB------X---------------------o--o----X-?---o--o-------Xo----o-M------X---X-X?--------------------X----o--
----------o--------------M----------?---o--o-M--o--oo-------B----------o-M--------Xo-----X-----X-----B-M-o-----M---Bo------------o------X----XB-----B----M----M---X----?--------------?-------X-o-------
--X-------X-o-M---o---------?----oX-----------------------------X----o---------M---------------------------o----X-X---------------X--X-----------------M-------X-o---X---MX-ooMXM-------X---X-------B--v
-----B-X-------oX---B----B-------o-------X--o---?------M---------B----------------?---XB---?-----M----M--------------o?---XXo---o----Boo-------------------M-------o---M----o----X-o?B-----------------f
-------XXX---B------X----o--BB----o-------?-------------o------B------?---BM---X?-----Xo------B--------?------------------------------X------M-X-o-M--------B--M----oM-----M----?-X----o------------oM-f
----o-----M----?-------------------o--------?--------o---?---o------B-------X-----M-?------B---X?--oB---X--Xo--B---------MXoo----?X-o---------BX-----?------X------------------------?--o-X-----M-X---Mf
-----------oM----------------X-----------B------------X-----X-------------o----------oB-----X------------?-----X----X------X-----------X---M--X--o------Mo------X----XX-X-B--------------B-------M-----f
-----o--M------M-----------?M---o?----MX--------------B----o---?-----oo-------------------?X---M-----------M-oM-----------?--X----X---B---------------------X-----?-B-o?----o---o-B------XX--M-----o-X-f
---------XMB-------XM--------BX-E--------Mo-M-X----X----X-----------X--o-------M-?X?----------------X-----E---------?----------o--------XX-?-XM?-------------------B----BX---------X-BoX------X-------Xf
m-o--------Xo----X----X---------XX--------------------X---------X------B-o------------X--X--X-------o-----X------XX---------------------------------X-X----o-o--------X-X------X-----X----X-X---X--o--XX
XXXX-XXXXXXXXXXXXXXXXX-X-XX-XXXXXXXXXXX-XXXXXXXXXX-XXXXXXXXXXXXXXXXXXXXXXXXXX---XXXXXXXXXXXXXX--XX--XXXXXXX-XXX-XXXXXXXX-XXXXXXXXXXXXXXXXXXXXXXXXXXXXXXXXXXXXXXXXXXXXXXXXXXXXXXXXXXXXXXXXXXXXXXXXXXXXXXX
