--------------------------------------------------------------------------------------------------------------------------------------------------------------------------------------------------------
--------------------------------------------------------------------------------------------------------------------------------------------------------------------------------------------------------
--------------------------------------------------------------------------------------------------------------------------------------------------------------------------------------------------------
------X--XM-B--?-----M--XX--M---X------X-M--M---------------?----B-----B?-----M--------------------X--ooo-M-X-oo----------?------X---M-o--M?---?-o-M--X-------------------o--o???-----X-----o--M--X-----
----X---X----------B---------BB?----------------------------------M----------------------------------------------X---------M------XX---X-----B----------X----?-----------X--------X-B-----X-----------o-
----B------M--?---X--B?-----o-----X---X----B-----?--XMX--?------------B-X-------X-------B---X-----X----X--o--------M-X------X-----o-E-X--------------XM-------X--------oX------X---------------oX---XoX-
---B-X---o-------M------B--------M--X---o-------------------------B----------X------XX-X-----?----o--M----XX?M------X--o----XMX-XM-MMX---?-o---B--------------X---B---oX-B------------MXo-o--B----oX----
----------?-X------o---------------o--o------o-o---------?-------------X-------o-------------------------------X---o-?----M---o?-------o--B--X-B--X-----M----X-----?---------X------X------X----Xo----Xv
------------Xo-------M----------X-----------oX-----X--------------X---X---X--?------M----o---?---oX---XXo-o--------X-------o--------o-------X-?----------X---Bo--X-----------Xo----------M-----------X-f
------?-B--M--?--------X------M-X-o-----X--o--------?-o-----M-----------?--?-----------------------X-o----------B-----------X-oE-------?X----------X--B--o----X---X--------X----?-?-------o----o----o--f
--------------------?-----------------XX----------M--X--?------------X---------X--Xo----------------B--?-----X-------M---------M---?--E-o-------?---o-------B------------o----o-----B-------B--o-------f
----o-----------Xo----?---------o-o-------------o---X-----------------o-----M-o--?---XM-X-X----X-X---X--M----X--------------?---------X---?--MM-----------------X----------B---------o-------X--M-X---?f
-----BX----------o-B---X--M-----------------X-----M------o--------M-X---M-------------------------o--o---------o-----------------X?---------------------o----?-X--M-X--------o------X------B-XM--B-----f
----------BMX-o-------X-----------------o-----?M-----X------?-------------M--X-B---o------X--o---X-X--X---------o-------o-o---?----------o--B--oo----M-----?--o------M---------Eo-X---------X---B--o--Bf
m---Xoo--o------------X-X-Xo----X-------o-X-----------X-------X--------------------o---------XB---------X-X---------X--X-------o--X---oX-----X-----B---o------X--o--------XX---B----------X-X-----X---XX
XX-XXXXXXXXXXXXX-XX-XXXXXXXXXXX--XXXX--XXX--XXXXXX-XXXXX--XX-XXX-XXXXXXXXXXX-XXXXXXXXXXXXXXX--X-X-XXXXXXXXXXXXXXXXXXXXX-XXXXXX-XXXXXXXXXXXXXXXXXXXXXXXXXXXXXXXXXXXXXXXXXXXXXXXXXXXXXXXXXXXXXXXXXXXXXXXXX
