--------------------------------------------------------------------------------------------------------------------------------------------------------------------------------------------------------
--------------------------------------------------------------------------------------------------------------------------------------------------------------------------------------------------------
--------------------------------------------------------------------------------------------------------------------------------------------------------------------------------------------------------
--------o-----X-------------------B---M------X-----------o--X----------------------X--------o-------------X------------------o-----X----X----------o-------o-----------M-------M-B--X--M-----M-oMo-MM---
--M-X----X-----B-X--X------------o-X-----?-------X-----?------X--o------o-?XX---o--------X-o-X----------X--X------X---X---B-o--X?-X------X--------?--Xo-?-M--MB------o--M----X-----?B------------X------
------o----?--X--B--------o--XM---?---------------XM-o----o--------?-B--------X--?-E----------B------------B?-?---o---X-------X---X--X----X-o-o------Xo---------X?-o------M----o?------M-?----?---oo----
-------------X----M-X----o---------M-??---M-------------------M-----?------?------oX---------?-M-BB----X------------------------X----B---M--X-X-M---X------MX------X----------o------X-----o----X-------
-M-----X-?--o----------------o?---------------X----------------B-o---M--?--------o--------o-----------------?--M---M--------------M----B-----------?-X---M-----o----XM?----XM----------------X?---oo--?v
------oX----X----?-----o-------X--o----?---------------------?----?--------X-----------?----------X----o--------o----X-----X--------X-------M----------M-----?-----X-----X-----------o-----------oBX---f
---------------M---oXM---M-X-------------?-X-MBo------B-------------o-X-------X---oE-------Xo-------------?-o---oX-------------------o-o---------B-------Xo------------BX---M-B-o------X---?--M-B------f
--B--------------XX--------------o----E---------X-----------------------E---------oX--X---------X--o-o--B------------o--------o-XB-X----B-XX-----X-----X-----M--------------------?---X--?--X--------oXf
----XXX-BX-X-X-XXX-BXXXXXXX-X-X---X?-XX?XMXo--XX---oX-XXXX?X----X?BX-X-XXX-XXX-X-X--XX--X----o-----XX-?--XX-----X---X-oXXXo?------o------X-X-X?---------o------X---X-?X-MX--------------------------B--f
------o-X---------------------oX-----------o------------------------B--------XB---XBXX-TX---M--o-o-----M----oo----X----------X---M-X-XX-X----------X---X--M------B----X----M-----X-M--------o---X-----Mf
--------------X------------X-----------?---------------o----X-------o----?-------------|-B---Xo----X----------o----------?-----B--------ooB--B---M--X-o--------M--X--X---------MMo--M-XB-----B--X------f
mX--X------------X--------------------------X----o---X-X------------X------------o-----XXX-Bo------------------X-------------------o---------B----X----------------------o-------B-----------X-X--XX-XXX
XXXXXX-XXXXXXXXXXXXXXXX--XXXXXXXXXXXXXXXX-X-XXXX-XXXXXXXX-XX-XXXX-XXXXXX-XXXXXXX-XXXX-XXXXXXXXXXXXXXXXXXXXX-XXXXXXXXX-XX---XXXXXXXXXXXXXXXXXXXXXXXXXXXXXXXXXXXXXXXXXXXXXXXXXXXXXXXXXXXXXXXXXXXXXXXXXXXXX
