--------------------------------------------------------------------------------------------------------------------------------------------------------------------------------------------------------
--------------------------------------------------------------------------------------------------------------------------------------------------------------------------------------------------------
--------------------------------------------------------------------------------------------------------------------------------------------------------------------------------------------------------
---------B---?-----------------------------------------------X----------------------------------M-X-----X-----------------------------?---------M------------------------------------------------?------
---X-------------------X---------M----o--------------oX----------M----X----------?-----X?-------------?-o-------X-o-------------------------------?X------BB-----------X-----------?------X----o-o------
----X--------X---------------X----X?----------X------MB--------?---------?-?----?--?---------X--------------Bo----X------------X------X------------------X---o----X------?-MX---------X-----------------
-------?----------X-----------------------X---X-----------------------------o-----------?--------?--------o-----o----------M-------?M--?-o?---X--------------M---------------------o-X------------------
--M--X----------------?----------------o-----M-----------?-----------?--M---X-----oM----------------------------------B-----------------o--------------------------------X---------?--M----------B-----v
--------------------------?-----------------------------?----------X----------------------------------M--------------------M------------------------B----------------------------------?--o------------f
---X--------------X------------------------X------------------------------oB------------------M------?---o-?--------------------X--------B--------o-----------M----M-------------------------o---X-X---f
-o--B---o-----------o------M----------------------------------B----M--?X-------o--------------------M------------------B--------X---M------o-------------------oM---------X---X-----o-----------M--o---f
----X------------------BX--X--X-------?----X-------X--XX----XX---------X----------XX-----M----X------------XX----------X--X---------------M-------X--?-------X--M-M------------------------X-?------X--f
------?-----o-------------------------------X-X---M---------------------X------------------------------------M------------------o-------o---M------------X---M-------------------?-----------------T---f
-------?------X------M--------?----B------------------M-X--------XX--------X---MM-------------M-------o-------------------------------------------------------o-M-?---------B-------M-----?-X--X---|---f
m-----o-----------------------------------------B--------------X-----------------------------------------------------------------------oX---------------------------o-------X-----------X-B---X----X---X
XX-XXXX-XXXXX-XXXXXXXXXXXXXXXXXXXXXXXX-XXXXXXXXX-XXXXXXXXXXXXXXXXX-XXXX-XXXXXXXXXXXXXXXXXXXXXXXX-XXXXXXXXXX-XX-XXXXXXXXXXX-XXXX-XXXXXXXXXXXXXXXXXXXXXXXXXXXXXXXXXXXXXXXXXXXXXXXXXXXXXXXXXXXXXXXXXXXXXXXX
