--------------------------------------------------------------------------------------------------------------------------------------------------------------------------------------------------------
--------------------------------------------------------------------------------------------------------------------------------------------------------------------------------------------------------
--------------------------------------------------------------------------------------------------------------------------------------------------------------------------------------------------------
-----------X--------------------B---------B-------B---------------o--?X------X----B-------------X------o----------------XX------o-oB-X----?-----X-----XX-------o-----M-----X---XMo-----X---o------XM----
------------------B-----X-----B---------------?-o--------o-oX---BX--------X-----------M---X------M---Xo----?-----XX------XXB---X-------------X-----o---o----X-----------------------------X---X---------
-----Bo-X--M--X--XX-------X-?---------M-X-MXX--B-------B-o-----o------XBo----?M---XX----XMB--o----------------------XB--------X--------X---BB---B-----X------M--X----M---M-o?---oBB----------X--X-------
-o--?--------oX-----o----B----M-----o--X------?-----M--------X------M----M-M----------?----X-----BB----------o-------X-----------o--M-------------X-Xo-X----------o--------------------Xo-M-----BB-B?---
---------------X---------B----------B-X---------?-X---?M----X---------------o-M?---?------------o----?-X-B-----------------o----------X----o--o-----------X-o?--M?-------X-------o-M---o---X-?---------v
-----X--o--o----------o------?----------X-----------------o-o?-------M-M----o--------?M--o---X-------------------------------?-------o-X-----B---?------------X----X---X-o--XX--M-----------------o-?-Bf
-B-MM----------X-M-----o-------X-------o---X---?B--------------M-B-----------M------------M?--M-XB---Mo-XB-----?---------M-X---o-o?------X--M-M-----oX-BX--------------B-----X-------------B-----oX----f
-------------o------M----X---X--B--X-----------------o--B----B------------------------------------o-------------------------------------o-B----------X-----MM----o-------------------X-oo-o--XM----?--Mf
-XX---XX-?X-X-X-X----X?XX-XXX-Xo-XX-XX--XX--XX---?XX-X-X-X---XXBX?--XXX-X--XXX-XX---MXX--X--X---X---X-B---?XX--XX----X-XX?XXX-X?X--oM-o------------------------X-B-X--X------Mo----------X-----o-------f
-----M-------B-B-X--B--o--------------------------------M-M-o-----------X-o---------------??-Xo-oX-o--------------XT---------o-----------?----o---------?X--X-----X---------------------X-X------------f
---B-----o-------B-------------------X----X-?-----B------------------?o--o---------------------M--X--X-------------|-M---o-----------X?---------M--------X------B--X-----M----X----------B-----X-XX----f
m----o-------X-X---o-------------B-----X---------o-----X-X--X-----------XX-----X-------oX-------X-X---B-------X---oX----X----------X---X---X--------X----------------------------------X------X-----XoXX
XXX-XXXX-XXXXXXXX-XXXX-XX-XX-XXXXXX-X-XXXX-XXX-XXXXX-XXXXXXXXXX-XXXXXXX-XXXX-XXXXXXXX-XXXXXXX-XXXXXXXXXXXXXX--XXX-XXXXXXX-XXXXXXXXXXXXXXXXXXXXXXXXXXXXXXXXXXXXXXXXXXXXXXXXXXXXXXXXXXXXXXXXXXXXXXXXXXXXXX
