--------------------------------------------------------------------------------------------------------------------------------------------------------------------------------------------------------
--------------------------------------------------------------------------------------------------------------------------------------------------------------------------------------------------------
--------------------------------------------------------------------------------------------------------------------------------------------------------------------------------------------------------
--------------------------------------------------------------------------------------------------------------------------------------------------------------------------------------------------------
--------------------------------------------------------------------------------------------------------------------------------------------------------------------------------------------------------
--------------------------------------------------------------------------------------------------------------------------------------------------------------------------------------------------------
--------------------------------------------------------------------------------------------------------------------------------------------------------------------------------------------------------
-------------------------------------------------------------------------------------------------------------------------------------------------------------------------------------------------------f
---------------------------------------X------------------X--------------------------------------------------------------------------------------------------------------------------------------------f
--------------------------X----X----------------------XX---------------------------X---X-------------------------X--------------X----------------------------X--------------X--------------X-X-------X-f
------------X-------X---------------------X---------X-----------X----------------X--------------X---------X--X----------X-----X------------X------------X-------------X-----------------X--------------f
-------X--X-X-------X----XXXX--X---X------------X----XX-------X--X----X------X-------XXX-----------X---X---------XX----------------X---------X----------X-XX-----X--X-X-X-X-X------XX--------X-----X---f
m--XX-XXX-----XX--------X-X-XX---XXX---XX----XX-------X-X-X--X--X-----XX-XX-------XXXX-----X--X-X-X--X----X-----X------X-----XX-----XX-------X---XXX---------X-X----X---XXXXX------XX----X-X-X-X-----X-X
X-X---X---XXX-X-X-X-X-----XX---X--XX---X--------XXX------X--X-----XX---X--XX-X-X--X-X-X---XX-X---------X-X--------X---X--XXXX---XXX---------XX-X---XX-X---------X--X---X-------X-X-XXX-X------X--XXX-XXX
--------------------------X--------X--------------X------------------------------------------------------------X----X-----------------------------------X----------------------X----------X------------v
-------------------------------------------------------------------------------------------------------------------------------------------------------------------------------------------------------f
