--------------------------------------------------------------------------------------------------------------------------------------------------------------------------------------------------------
--------------------------------------------------------------------------------------------------------------------------------------------------------------------------------------------------------
--------------------------------------------------------------------------------------------------------------------------------------------------------------------------------------------------------
-------X-----?-----------------------------------------------X-------?--------------------------M-X-----M-----?-------------?---------?----?----M-------------------------------------?----------?------
---X-----M-------------X---------------X---------M---oX---------------X----------?-----X?o------------?-o-------X-o-------------------------------?-------BB-----------X-----------?------X----o-o------
----X--?-----X---------------X----------------X------MB--------?---------?-?----?--?---------X--------------B---------?--------X-------------------------X---o----XX-------MX---------------------------
-------?----------X-----------------M-----X---------------------------------o-----------?-----------------o-----o-----------------?-M--?-o-----------------?--------------------------------------------
--M--X---X------------?----------------o-----M-----------------------?--M---X------M----------------------------------B-----------------------?--------------------------X--------B---M-----?----B-----v
--------------------------------------------------------?----------X--------------------------------o------------------------X----------------------B------------------------------B-M-?--o------------f
-------------------------------------------X--M----------------------------B------------------M----------o----------------------X-----------------o-----------M----M---o---------------------o---X-X---f
-o--B---o-----------o------M--------?------------------------------M--?X-----o-o------------o-----------------------------------X---M------o--------------------M---------X---X-----------------M--o---f
----X-----------------oBX--X--X-X--X--?----X------XX--XX-----X---------X-?---------X----------X------------X-----------X----X-------------M----------?----------M-M------------------------X-?---------f
------?-----o-------------------------------X-----M---M-----------------X---------------------------------M--M------------------o-------o--------------------M-------------------------------------T---f
--X--------X--B------M--------?----B-------B---------oM-X------------------X---M-X------------M-------o--------------------------B----------------------------o-M-?------?-B--------M-----?--------|---f
m-----o-----------------------------------------B---------------------------------------------------------------------------------------X-----------------------------------X-----------X-B---X----X---X
XX-XXXXXX-XXX-XXXXXXXXXXXXXXXXXXXXXXXX-XXXXXXXXXXXXXXXXXXXXXXXXXXX-XXXXXXXXXXXXXXXXXXXXXXXXXXXXX-XXXXXXXXXX-XXXXXXXXXXXXXX-XXXX-XXXXXXXXXXXXXXXXXXXXXXXXXXXXXXXXXXXXXXXXXXXXXXXXXXXXXXXXXXXXXXXXXXXXXXXX
