--------------------------------------------------------------------------------------------------------------------------------------------------------------------------------------------------------
--------------------------------------------------------------------------------------------------------------------------------------------------------------------------------------------------------
--------------------------------------------------------------------------------------------------------------------------------------------------------------------------------------------------------
----------------------X--------X--X----------o--X---X-o---X----X----------X--------X-M------------?oM-----M----------------------X--X---------?-----------o-Xo-------M----o--X--X---------MX----E--X----
--------M---------?M?X--o----X----------o-----B--M--o--o---X--------------X---------------------?-----B----o-------o-X--X-------------------M-----?X--X-----o-o---Xo--------------o---?---------X-------
---------?---X-B?----------oo------Mo--X----X?----X--?-o-----------B-?o------o--B-o-------X--B--------X?------------X--------B--X-X--ooMXB---?-XM----o-------------X----X--------B-----X-------------M--
----Mo-----------E-X?-?-----B-------X----------------------X-----------------------o---oX-------M--X-B-------X------------------X---------X-----------oMo----X---M-----oE--B--------X------MX-----------
-B------M------o-B----------------?----------M-----------------------------X--?X-?------X--------X-X------o----------------------------------X----------o-?-------XB--?-X-B--------------o---X-X----X--v
----------M--X-------??------X--X--------XX--------o-o-----M--?M?----?--------------------------------------o---------?------X---------B-X------X----XMM----X-------X--B------?-M-X--X---o--XX---------f
-----?-X-------------------------XM-M-----X-o-----E----B-o--X------B------X----o-X------X??--B--------------------X----------o---B--X-----oX---o-o--------XX-----X---XX-o-X----------X-XX-M?X---Mo--?o-f
-----------------X--o--------M---------X-----Mo-X-B--X--o-B-----------o-------?--------M----------B----M---o----------------------X--X--------B-------Xo-------?-----------X-----oo-X----------------X-f
---X---------o--------------------B---oo---------------oXo--?------X--BM----------X-----------M----XX------------------------X--------------X---MX---?--?o-o---------B--------------------o------------f
---X--M-----------X-?-----------oM---oB------X----?-E--------X-------------o----B---------X---------X-------o-----Xo----B-o------M------B---o-----B-----------X----X------??-------X?--XX---X--------o-f
-------------o---o-----------?---------?------?----XX----X---o-M----------X-------------------X---B------o-------M-------------X--X-M?X----------------------M--B----------------oX--X--o-BoXXX-----Xo-f
mB------X-oo--X-X-----o--------X--------X---X-----------o---X---------X-X-----X------X-X---o---------------XX-------X--X----X----B------X-----B------------------o--X-o-oo-----o---B-oXBX---BX-X-o-o--XX
XXX-X-XXXXXXX-X-XXXXXXXXXXX-XXXXXXXXXXXXXXXXXXXX-X-XXXXXXXXXXXXXXX-XXXXXX--XXXXXXXXXXXXXXXXX-XXXXXXXXXXXX-XXXX--XXXXXXXXXXXX-XXXXXXXXXXXXXXXXXXXXXXXXXXXXXXXXXXXXXXXXXXXXXXXXXXXXXXXXXXXXXXXXXXXXXXXXXXX
