--------------------------------------------------------------------------------------------------------------------------------------------------------------------------------------------------------
--------------------------------------------------------------------------------------------------------------------------------------------------------------------------------------------------------
--------------------------------------------------------------------------------------------------------------------------------------------------------------------------------------------------------
--M--M--------------X----------X-X-o---MM---------B-----M-E--o---X----X--------M----o--o--B------M??------------M-o----o--M----BB?M---XX--B------o------X-----o-----o-XXB-o-?------------M-----o-X------
------------?----o---------B---o----X--------M-?X---------B-?----------------M--------X------X-------------MX------X----X-----X---------BM----------------------X-o--o--oX---------M-------?-----X---X--
-X----B---B--------------o--------X----X--X----------X--------oXo-o-MX---------B----Mo---------o---X---X-----?-----o--X---M---X---o-o--------?----oM-XX------M-X----------B-------------X---M-X----X--B-
---?---M---?X----?-----B----oB----o------------?-X----?oX--X-M-----------X---?--------o--------X---------------X------oo-----X--X-X--X----X----------------o-------MoX----o---------X--B------X----XoM--
-----o--------------------o-B-------?-X----o-o---X------X?----o------XX--B----Mo--X?-oX-----o-----B-MX----------MB--X--o-X-MM--B-o----B-----B---------oo-X--X---------o-------oX------o--o-------------v
-M---X---o?-X---B-----oo-----o?-B--------------B---M??B-----X--X---X---B---XX----X---------o-BXXX-----B-------o-------------------B-?------B--------------?-o-o-oo---------MB----o-------B-----B-------f
---------------XX--oX--X---o----o---o--XB-------o---------oM------B------------------X--oo--------o--------X----------M----X-BX?--X---?---M----B---M-------B-----X?----M------------?--------MX--X---o-f
---X---B-XM------ME-X----o-o------X---MB----X----------MoX----M-XX----?-?-B--X---?----M?--?oo--------X-MB-o------------X-X---------X------------?X-------------------?------B---BB-------X-o---M----o-of
--------X------X--X--?--X---M---X-BM-----o----X-----M?-------------B------BXo--M--------X-------M?---------X---Mo-X-X-o---X?X----X--------Moo---------X---X--X-M------X-----oX-X-----o------------o----f
-----X---?XX----X?o-----------BBo?--o---?---M--B-B----o-----B--B----o--------M---?-M------------------X--M--M----X------o---X---o-o-X---M----------------oXo-----o---o--------?o-M-M--T------XXX---M---f
--------------o-----oXM---B-------B--M---M----?--oM-MX-X-o------X----X-----X--o-----o-X----X-X-X----------X--XX---X?---?o----------X-o-----M------------o-------o-----?----o--------oX|--X---X--X------f
m-o-----Xo---------o---o-ooo-o--X-----X-----X----------X---------B-----X---B-Xo-----X--X-X-------o--X-------X-----------X------X---------X----X--o--B---o--X-------o----X---------X---X--Xo--X--B-BXX-XX
XXXXXX-X-XXXXX-XXXXX-XXX-XXX-XXXXXXXXXXXXXXXXXXX-XXXXXXXXXXXXX--XX-X-XXXXXXXXXXXXXXXXXXX-XXXXXXXXXXXXXX-XXXXXXXXX-XX-XXXXXXXXXXXXXXXXXXXXXXXXXXXXXXXXXXXXXXXXXXXXXXXXXXXXXXXXXXXXXXXXXXXXXXXXXXXXXXXXXXX
