--------------------------------------------------------------------------------------------------------------------------------------------------------------------------------------------------------
--------------------------------------------------------------------------------------------------------------------------------------------------------------------------------------------------------
--------------------------------------------------------------------------------------------------------------------------------------------------------------------------------------------------------
--X----B-------M-------------X--B-----X-----?o--?-B-----?-??-o--------X---X--Xo--o----o-----------X--X-B---X---?----o--o---------o-?--------MMo--?----?-M-X---?o------X----X-----X--------M--M-B--X?-?--
-?-X---X------------BM--X-------B---X---oo-------------------------o-o---X-----B-B--------B-?----------------------MX---XX---?---------------------X------o-X-------X----------M-----o--------Xo-o------
-----Bo---------X-------------?---o-----X--------X-----X---B------M----X--------X-?--BX------o---X-----------BX-------B?--X----MMXo-----X--B-o------o-X-----------------XM-X?-----BX----X---------------
-?-----o-------M--X?-MB-----?------------o----M--------------------------M---------X--------------B--XX---XX-----------------o------o---o-o-------oo-o-------B-------M----------X---------o--XME-X------
----------------?--------------------------------?--?---E--X---o-----X-----------X----------X--?o--M-------o--------o---XX-o-----------E-o-oX-o--------o----o----?---------o---BX--o-----------M?--B---v
-------M----M-------X---------Xo--B----------M-o--?-----?--oooX-------------?---------B---BM-----------------------o-Xoo---Eo?--M----o-X----------X-----------X-------------X---------BX---------------f
-o?M----------------BB-o----------------X--M-------------------M---MB----o-----X----------------X---X-o--o-------X--------??-----o------oX---X------o--X-M----XX--------?------------M----o-o---M-X----f
----X--o--------X----------o----B----------------------B---------------X------?---X----------X-----o---------M----------X-------------X-----------o-------o--X--Bo-----------------------B----X------oMf
---XX---XXX?XXX--XXX-o--MX-----X----XB-X-X?XX?-XX-XX-X------XM-XX-XoXX--X---X---X--XXX--?X--B-XoX---XX-XX-XX---X-X--o-XX---X-?X?------------B----X----M-----M--X------X--X----o-------E----------------f
------XT-------B------o----o----------------------------------------X----E---B------X---------B-oX---o------?-----oo--X-?To-----?o-------------X---------XM---o-M-X----X-------B--X-X-M-X--X-XoB-------f
------X|--X------o------------------X-----X---M?-X-----X----o-X------X---X----o------------------X-----------o------?----|B---------------X-Bo---o--X-------M--------oM---M---X---o-X----B-----X-XX----f
mX-X---X---------------X-X-------X--X----B------------------X--o-----X-X-X----oX--------------XoX---o-B---X-X-X-X-----B--XX-----X---BX-----X---------Xo----------o-X--------------X-B--------X-X-X----XX
XXXXXXXXX-XXXXXXXXXXXXXXXX-XXXXXXXXXXXXXXXXX--XXXXXX-XXXXXXXXXXXXXXXXXXXXXXXX-XXXXXX-XXXXXXXXXXXXXXXXXXXXXX-XXXXXXXXXXXXXXXXXXX-XXXXXXXXXXXXXXXXXXXXXXXXXXXXXXXXXXXXXXXXXXXXXXXXXXXXXXXXXXXXXXXXXXXXXXXX
