--------------------------------------------------------------------------------------------------------------------------------------------------------------------------------------------------------
--------------------------------------------------------------------------------------------------------------------------------------------------------------------------------------------------------
--------------------------------------------------------------------------------------------------------------------------------------------------------------------------------------------------------
-?----o--o-M-M---------o---??-oX-----MXX---X------oo----X-------?-------Xo-X-----o-----?-----B-oo-------X-o---B-----X----------------------?----------o------Xoo------o------?-------X--------X----MMX--
-------?-----------B-X---X---o----o-------X----------X-MX-----X------o------B-----X--------X-X----?X---------?---X---------B-X--X--B----oB--------B--o----oX-X----o------XX---?-X-oo---X----o-----------
-?--X----B--------------MXoBo-X-B--oo-o-----?----MXB-----o----X-Xo-----------?----o----o---oM------------------o-------XB-X---X-----B-----X---B--X----X-XX----B-------X--------M--Xo-----X---X-o-B--o---
------MX-------X------B----X--------o---XX---B-----o-o-----X---o----E----o------X--------------------BB-Xo----?-----XM----XX------X-XoBo-X--X---XX---o----o----X---X---BB---MX--X---o-------o-----------
-----------X----o-------------M-XXMo--------------------o-----------X--o------E----Xo-?-X--oM?oM--BBX---o--X----------X-oX-------X---oX---XM---------------B-------------------X-------M---o---BBo-----v
-----o--XB-----------------X-------X--?-o--Xo-X-M----------X----X-?--o---M-MX-X--------B-----------o---------X-----X-------o-----------X-----o--M-o----?--M-?-X-o------oXo-------M-------X----?--------f
----B-M------X------------X----B?------B--o--------------o--?--?------X----------X---o-----XX-----X-o--M---------M--------X--o---X--o--------B---------------o-----B----B----?---------o?---X----X-?---f
-----------X--X----X-----------------o-X-B-----X---o--o-?-------o--------?X-o--------------------X---------Bo-----------o-----M--XM?------X----------?-o-------X----------o---M?----?------------o-----f
-M-----B-------X-X?--X----XM---XX----X-----oo---M----------?-----X-----------X---M----------o-?---X-X-----M-----X---------X-X-----------B----XE---------?X---?----B--------X----o----------?-X----X-o-Bf
-----o--o-------o-----B-oX---X-----------Xo---o---o---------XB?-X-XX?---M---------X------XX-----------------?Mo--XB--X--M--oB---M-?-----X-----X-------B--------X-o----X------X------o---------X----X--Xf
------o------?-----------o------------------------------BX-------?---o------B---------X-X---M?-XM----X--------X?---X---------MX-------X--Mo----?---B-B-X----X---M--M?----o-?-o---X---XX--oX--X---------f
m------X-Xo-----------------B-----X-B-B-o---X-X-o-Bo------X---------o-----BX------------------o--X----o-X---------------------BX------o------X---B-------------------------------------XX-X--B-X-----B-X
XXXXXXXXXXXXX-XXXXXXXXXXXXXXXXXXX-XXXXXXXX-XXXXXXXXXXXX-XXXXXXXXXX-XXXXXXXXXX-XXXXXXXX-XXXXXXXXX--XXXXXXXXXXXXXXXXXXXXXXXX-XXXXXXXXXXXXXXXXXXXXXXXXXXXXXXXXXXXXXXXXXXXXXXXXXXXXXXXXXXXXXXXXXXXXXXXXXXXXX
