--------------------------------------------------------------------------------------------------------------------------------------------------------------------------------------------------------
--------------------------------------------------------------------------------------------------------------------------------------------------------------------------------------------------------
--------------------------------------------------------------------------------------------------------------------------------------------------------------------------------------------------------
-------------MX------------X---o-XX----Boo--X-------B--------X-----------o----X---o---o?X--------o----B------X-----o-----------X------M------Xo------o---M--X--------?B----M--o--?-----?-?---X-X--oM----
---B-------o----BoX--------------B-B-------XX--------XX----o-------MM----------M-M---------------X----------X----------o---Xo----X--B------------------------------------X----X------X----B-X-----------
-oB---X--X-----------?----X?-B-?----XX--------MX---oo---o---B-Bo----------X--B---------X---X--Mo--------X?---BB-M---X-----X--MoX----------ooB-?-MX---?---o?-----XB-o-M-X-o--?---M--XoBX---------B-X?----
--X----BX--o?-B-X--B----X---------o-----X-------?--X--o-------------------B--o-X-o-------o--X---o-X--Xo---?X-----?---?-BX------------X--B----------X--X-M-----X-B-o-------?---------o--------X----------
-----B-----------BMoo-M--X-XB--------B-------o----------o--------------------------------X---------o----------------------o-------?----o-X---------XM-------XM-----X---X----?o----o----X--X-o--?o-ooM--v
-M------BX--X-?--------X--X-------------X--o---o-oX--o-----M-X-----o--B----X-----X---?X----o---o---X-----------X-X-------o-----X---M---o----X--X--X------X----B---X----X------X--?-B-----X---XE--------f
------X-o--X--------------------X-----X-X---------------Xo--------M---o-------B--o?o------B---------M----Mo---?--o--Xo-M-------------------------o----o---?-----X-------------X---------------M-------Xf
--X----M---B-------o---M---X-o-----X-o---------o----?MB---------X------X--------------E-Xo----X--?---------o---X----X------M-------B-------o---MX--X------------oX-M-o------------o-X--o--------?X----of
----------------------------------------o-B--o---------------M-M-------X-M--X--o-X---oB--------M-----o------------------MX-----?X------------X--oX---X----XB-oo-----X---?------o------X-o-----X--o-B---f
--?--X?-------o---X--XB----X----------?-Xo----------------------o---------M--B-o----------o-B-----?---B----B-X-----X-------B-M-------------B---B----X--B-BXo--------------XXX-------o-----X------------f
----B----X-X-------------------o-oo--------o----------X--XXM-----------o---o?-?--------X-----------------X?--B----o-X----------X-----o-----------Bo-oo-------?--------B-oB-------M-oB--M-oB---X------XBf
m-------X--oo--X------o----o----------B-B-B---X-------------B-------X----o--------X----------------------------X-----X----B---oX--X-----------B-X------------------------X----oX--XX------X-----X-X----X
XXXXXXXXXXXXXXXXXXXXXXXXXXXXXXXXX-XXXXXXX-XX--XXXXXXXXXXX-X-XXXXXXXXXXXXXXXXX--XXX-XX-XXXXXXXXXXXXXX-XXXXXXXXXXXX--XXXXXXXXXXXXXXXXXXXXXXXXXXXXXXXXXXXXXXXXXXXXXXXXXXXXXXXXXXXXXXXXXXXXXXXXXXXXXXXXXXXXX
