--------------------------------------------------------------------------------------------------------------------------------------------------------------------------------------------------------
--------------------------------------------------------------------------------------------------------------------------------------------------------------------------------------------------------
--------------------------------------------------------------------------------------------------------------------------------------------------------------------------------------------------------
--X-----B-------oX--?-----Mo-----------X------o----------MM--X-----?X-----------X-X--------?----o?---------------X-----X---BM--X--o-Xo--------o--------X----X----o-----o-X---?----------XB--------X-----
----B---XMo------------X-----------------------------?--------X-----o--?--M-?------o-----X------------MX---X----oX-----XB---------o-----X--X-M--X-------X-----B---o-B---------------?XMo--o---M-MM-oXX--
------------X--------------B---X-----?--XX-XXX-----------oM----X-o-?------------XB----------o------X-----------------------X----X-----------------------oX--o----B-------X----o--M--------X-B-----------
-X------MM---?-------?-o---------------o-------X-------------?--XX----------X-M------X-----?B---------B------o-----------------X-------o----------M----X--?-XM-Mo---X--?--------------------------------
-----MX---X-----o?-B-----M-----B--oX----X-------oX---o--Xo---------------?---------o--M----------------o--------------?------X--X------------?-------?------------?-----------M------o--XX-?------MBo--v
---------------o--X----M--M---XB----Xo-?---------B--------o--XM?---------------o--X-------M----------M------?---------------o-X------?--------X----X-----------o-----------M---MMo---XX---------o------f
-----M----------M--?-X------------------BB--------M----oo---X----------o----MX---?----M------?M-X--------M---------X---M--------oo------?------X------------?-M----X---X-o------------------o?-----X--Mf
----------X------------------M--B--------------?-------------------------------o----------X--------E---------B-------------o-------B-M---------o--o-----------------M-o---M---?----X----B?-------oX----f
--X-X-?--XX-XXX-X-XooXX-XX----B--oBX--X--XXXX------X--XXX--oX--X-o-XXX---XXXXX--o--XXX-oX----X-XX-X?--oMX-XXXXXXX-X-XX--XXX--XX---X----M?-B---------M-o-------M------?--X---------o--------X--M-B----o-f
---------B-----?o----------o---------T-X------------X-----------X-----X--X---B-X-X--X-----B---------B--------------o--X--------X-----X-------------------------BB-X-----X-X-------------?M-X------oo?-Xf
----------M-B----------M-X-------M---|---M----X?o------Xo---B-B---------M---------X----------M---MM--?o------XX-MB-------------X-----------o-----o--M--------?--X---M----?---oo-----------X----X-------f
m--oX---------------------X--X-------X---------------------o----X---BX---X---------------------o-------X---oX------------X------B-X----Xo--Bo--oX-X-------------B------X----X-----o-X----Xo----X------BX
XXXXXXXX-XXXXXXXXXXXXXX-X-XXXXXXXXXXXXXXXXX-XXXXXXXXXXX-XXXX-XXXXXXXXXXXXXXXXXXXXXXXXXXXX-XXXXXXXXXXXXXXXXXXXXXXXXXXX--XXX--XXX-XXXXXXXXXXXXXXXXXXXXXXXXXXXXXXXXXXXXXXXXXXXXXXXXXXXXXXXXXXXXXXXXXXXXXXXX
