--------------------------------------------------------------------------------------------------------------------------------------------------------------------------------------------------------
--------------------------------------------------------------------------------------------------------------------------------------------------------------------------------------------------------
--------------------------------------------------------------------------------------------------------------------------------------------------------------------------------------------------------
--?X--XM------------------o?----X------o--?----------X--BX------B-o-o----------XX-----M---o--------M------oX--------?-----X-o--X-?---o---------X--X---o?----B---o--M-------X-o----------------X-MM-o--X-
---------------?--X--M--XB--------B-Xo---------B--X------------o-------X------oo------------BX------XoX-?---------o--o---M-----B---------B-?---------o----X?--------o--------------XX-ooX-X-oo----B-----
----?-----XMX-----------X---------B-B-B--------------o-----X----M?M-----------o-?------X-----X---XX-----------B---B---------M---XX------X---E-------o--BX----X------------Xo-X-MoX----------X-XX-X------
---------------------------X-------M---X-----------X----B----o---------X----------B----o--------------XX-----X--------------------?-M---oXo-XM?-M-----?-------X--oo--------------XM--XX--------Xo-------
---------X-------?---X-----o--?----------------X------------o-----------X-?-----o--X----------X-----?-X-o-X--------?XX---X-----------B-------------------o-----o------o----M---o---B-----oo---o--M--o--v
---X-X-------------------------------M----------?o------M---------X---X----XXB-------BM-o------M--------X-------M----X----------------------------o--M-----Xo------X--------------o---------o------?-M-f
-o--------?-----------X?-X-?------------------------XX-------------M-XXX-------X-BX-------X----------X-M-----------------X-?X-X?--------o--X--X-------o--------M---------------MX-----------B-X--------f
-------X---o------------o-----B-----o---o-------X---X-------------------------------E-XX--------B-------------------X--------------o----X---------MMX--X--X------Xoo---------------?o----X---B--MX-----f
-X---X--o?XX---X---X---XXX--XXoX-X-----X--XX-X--X-oX--X-XXXXoX-X-XXM-X--XoXXX-Xo-M--X------X--XX-XM-BXBXXoBXXXXXXX-----XX-B?-XM---o-XX---o-M-X-o-------XM-----X-------?--X---M----------X--M-X-----o---f
------------M----X---o?--------BX----------------BE-M--X-------------Bo------------B--M---M-X------------o---------o------------------X------------oE----B--M--X-----------------o---oX---------X---X--f
--------------M-B--------Bo-----X-?-----M---------X------------X---------M---M---X-----o-----B--------------?X-o---X------------o-oX--------o--MX---B-X-------ooo----B----X---Xo-----BXB-XX----oBX-----f
m----XX-X-X-----X---------XX-------XX----o-----X-o-----------XB---------------------o--o----------------------X-X--X-X-----------B---B--o-X-----o-----X-X--X-----XXo---o-X--X----------X-X-----X---o-X-X
XXXXXXXXXXX-XXXX-XXX--XXXXXXX-XXXX-XXXXXXXXX-X-XXXXXXXXXXXX-XXXXXXXXXXXXXXXXXXXXXXXXXXXXXX-XXXX-XXXXXXXXXXXXXXXXX--XXXXXXXXXXXXXXXXXXXXXXXXXXXXXXXXXXXXXXXXXXXXXXXXXXXXXXXXXXXXXXXXXXXXXXXXXXXXXXXXXXXXX
