--------------------------------------------------------------------------------------------------------------------------------------------------------------------------------------------------------
--------------------------------------------------------------------------------------------------------------------------------------------------------------------------------------------------------
--------------------------------------------------------------------------------------------------------------------------------------------------------------------------------------------------------
---oM----------X---?--------------X-XX-----------o----------oo-X---M------------------------o---Xo-o--------Xo-o--o---------MX---X----MMX------B------X-o?M-X-------------o-?--oMM--oX------M-----B-----
----------B---?------?-B-------XM--------o-----------o-----oX--X-----XB-X------------o---?-B-?----X---X--X------B----E----M---M--X-----------X----?-o------B---X---X---------M-----------------X--------
-XXX--X?X-------------X-----?----------o-o----?-------X-------X-?-?-X---X------B---X------Bo----o?-------X-----------X-X--------B--XX----------------o--------X-------B----X--X-------M--B-o-?--X-------
--------------------X--B------------------X------?--o------M?----------o----------?---------o------M??-X------------------?----X-------X------X--------oB-o--------X-----------X---------------?--X?M---
--X---o--X--------X-----B-----B-----------X----X--B-X---------------?B-------X---------------M--X-----X-----o---X-X---------MX---X----X---B--------o-----------X-XXX-?----XXB---o----------------------v
--BX--------M---------Xo---o-M-X-o-----------------o----?-------B-----------X-----------X-------------------------X-------X---o---X-----B---XX----o-----M-?---X-o---------------B---XB--------E--------f
----X-----X-------X---X---X--------o--------------o---------------?------oB------------------------o------------X--X---------?--------X---M------o---o------B-------------X--MXX---X-------B--X-?X-o-MXf
-X--X---------X-o-------------X-------MX---X-------------o---X-------------M--X--------?----------X---X-??----X-----o-----------XX--o--X--------M-?o-------M------o-----------BXo--------X-------------f
-------X-o-----M--o--X-B----------?----o-----o---------------------X----------------o------------o-M----------B--------------------------o?-----------------X--------X-X--o--X------M--------X---XXX---f
-----------B----Mo------o-o----------------------oo----------?--B-E-M-------?-----M---M------M-------o----------------T--o---X----M--Xo-B-----------MX---M-?X----o--X-----X-o---oo----X---X-----X--X-XXf
--X---o-----X-----Mo-----------o-X-----X-----o-----o--o-------o-X-X----------XB---------X--?---X----?-------?--o--oM--|--------o-------------------------------B--M-----?X---X-----XB?o---X------XB----f
m--X-X---X----o-------------------Xo------o----o---------X---o--X-----------X----o------------------------o------X----X----o-------X--------------------o-X-------------------XX---X-----XX-B---X-XoXX-X
XXXXXX-XX-XXXXXXXXXXXXXXXX-XXXXXXXXXX-XXXXXXXXXXXXXXXXXXXX--XXXXXXXXXXXXXXXX-XXXXXXXXXXXXXXXXXXXXXXXXXXXXXXXXXXXXX-X-XXXXXXXXXXXXXXXXXXXXXXXXXXXXXXXXXXXXXXXXXXXXXXXXXXXXXXXXXXXXXXXXXXXXXXXXXXXXXXXXXXX
