--------------------------------------------------------------------------------------------------------------------------------------------------------------------------------------------------------
--------------------------------------------------------------------------------------------------------------------------------------------------------------------------------------------------------
--------------------------------------------------------------------------------------------------------------------------------------------------------------------------------------------------------
--XoB-------X-XM----X----XM--X---X-oX--X---M-----X-----------o--o----oX------------M--B------X----o--o---X--------------o-------B?--?-----B------X----------o-----X------o--X?-o---o---------o-------?X-
------X--BB-----------?----B---X--oo--B------M--X-?-----B--------oX------o-------X----X-o---?----X-----------------X-X-X--o---------------------X------XMo----?---oX-----------------X-----?---X-XX-----
--MX-?Bo-----------------M---B---?o-------X--------------------o--o-X-------o---X--?-----?----Xo-X-Xo----X-o-?-M--------M---------o-oo---X-X--M---MM-XX---B----X------Xoo--------------oXB------?--X-o--
----------??-----------B----XB-----?---o-?-----------oX-E--X-----------Mo----?-----------------------?B--X?-----------o----------o----B---------------X-?X-?---X----o---X-o------Xo-----o----XX----oo---
--M---------o----M---?------o----X--M----------o-------XX-o--?-B----XX---BM----o------X-X-M----------------------------oo--M-----B--X--M----X---Xo------------o-------o--?---------X---?---o?-----o---Xv
----?-----?M------M---?--B----?o-o--------------?X?M--B----------------B---X-----M---XX-------X-B-----B-----o-oo---X--X--?---------------?---------o---X----oo----X-------M-----B?-------X-----B-------f
-M---M--X---o-X--------X----------B-----oM--MB------M-X---?--MBXo-B-X----------------o-oo-----oo-----?----X--X----X-B--E---X---?-----------o------o----------X------o---o-----------o-----X-M-X------XBf
-------B--------X---?----X--X-------o?------------?--M-----M--------o-X---------------o--------X--M---M-----X-X--M-----X----------o-------------XX--X---------M---------------oXB---X--M-X----X--------f
----?---X-?-X--X-XB--M----------X-BM----------X--------X------o---------?--o--oM---o----M--o----X----------X---M----X-------X-o-?-X-X------o--------------Xo-----o---o-------XB---------------------o-Mf
-oM--X-----------X--------------B---o---o--------B--M-o--o---X-B-B--o-T---B--M------------o-?----o----M--M----------------X-X-X--?----------o--------B-o------?------o---------?-----------X-Xo--------f
-------------o-------XX---Xo--?--B-------M---?---------------XX-X-XMX-|----X---o?o-?---------X-X------------XX-----o---------M-------X-X-o?-----M----o------------M---X-o-X--M-----------X-X----o-X----f
m-------X--------------X--X----------o----X------------X-X---o---B----X------X-------------------X-----o----------------X-o----X---Xo---------X---------B-----o-------------------X-X-BX---X--X-B-X---XX
XXXXXXXXXXXXXXXX-XXXXXXXXXXXXXXXXXXXXXXXXXXXXXXXXXXXXXXXXXXXXXXXXXXXXXX--XXXXXXXXXX-XXXXXXXXXXXXXXXXXXXXXXXXXXXXXXX-XXXXXXXXX-XXXXXXXXXXXXXXXXXXXXXXXXXXXXXXXXXXXXXXXXXXXXXXXXXXXXXXXXXXXXXXXXXXXXXXXXXX
