--------------------------------------------------------------------------------------------------------------------------------------------------------------------------------------------------------
--------------------------------------------------------------------------------------------------------------------------------------------------------------------------------------------------------
--------------------------------------------------------------------------------------------------------------------------------------------------------------------------------------------------------
-----?---X-X-------------M?------------X--------------B-------o----------M--o---------X--------XM------------------XX--oM---Mo-?-------M-----------------X---X-XMXM-?------X--?-B-----------------M-----
--------------------?o-------XX?X--MX-M------------B---?--E--o--------------B--M-X------o--?-------------M------M?-X------o--------o-----X--X---X-o-X-----M-M--------oX-XX-------MMM----o---XX-X------B-
--X------X-------o------o-X-X-----------X------o-?--------BM-X-o----B------------XBX---X----X----------X---X-?----------o-------X----------o--------XXo----------?-?-----XX-?------------Bo------E-E----
-----X--?------X---------------------o-------X----M----------------------------M---------X------X--------X-------------o-----?----------o--o-o-----------M-X--XM-------------XBX-----------------X-Xo---
---?------XX--?-----B-------o-o---?-X--?--B--------------B--------o---?-X----o---------X----o--X---------------------B--------------Mo-----------------------X-----X-------------o---X-B-?-o--oX-------v
-----------------X-o----o-----------------------?----------X-Mo----------------M-----?---X--X------o--XB-----M-----?------------o-----------?XX------oo--o----X---------o-X----X--M--XM--------X-------f
--------?-X---------------M------------X-X-X----------o---------ooXo---X-Mo-oM---------------------o-----B-------B---?---XX-?-----------MM?--X--B--X--oX-------B--X----o--X-o--X---------?--o-M-?------f
---EX--------------oX----------------M---------------------o---X---------------X-------------------------X-------------X-------------------X------M------------------X-----?---------X--------------X-?f
-XXXX-XX-o--XX-XXX---X-X---XXB-X-XXX--X-------X-???X---X---o-X?----oXX-Xo--X--M----XX-XoXX?XXXXoXXM-X---X-X-oM-XXo-oX---XM-X--?--BX----X----X-?------------M----o---M--MBM--o-XX---oX------X---?----o--f
--Xo----X------B-X--------X-X-----X-----o-----------------M-X------B---------------------------X----X-------------X---MX--M-?--XX---o--o---o---------Xo-M-----------------M-----------X-----X-----M---of
-------------------------o-?--------X-----X----X--o-----o--B--M-o------------X--B--------X?----------------------------------o----------M-----B----o-------------?-o----X---------Bo--Xo------X-----X--f
m---------X--X------B--------o-----X----------------X---------------X----------------X-----X-------X---------X-X------------o----o---------Xo------B---X-------X--X------o-----X------B------X--X---ooXX
XXXXXXX--XXXX--X-XXXXX-X-XXXXXXX-X-X-XXXXXXXXXX-XXXXXXXX-XXXXXXXXXXXX-XXXXXX-XXXXXXX-XX-XXXXXX--XX-XXXXXXXX-XX-XX-XXXXXXXXXXXXXXXXXXXXXXXXXXXXXXXXXXXXXXXXXXXXXXXXXXXXXXXXXXXXXXXXXXXXXXXXXXXXXXXXXXXXXX
