--------------------------------------------------------------------------------------------------------------------------------------------------------------------------------------------------------
--------------------------------------------------------------------------------------------------------------------------------------------------------------------------------------------------------
--------------------------------------------------------------------------------------------------------------------------------------------------------------------------------------------------------
------------X-X---------oX---o----M----------X---XX-------X-?o---------------?-------o---------MX-o-??--------------X-B----------X--?--B-BXo------X--B------o--------------X---o--M----XB----BXo-o------
---------XB---o-X------------------X-MBo-------o----X---?X-----------XMoXo-M---X------X---------oX-------B---X-X--------BB----Xo----------------X----B-X--oB-X-----M-?--o-------M--o--------------------
-----XX---o-----B--X------M---X----------M---X----X--X-------?----o?---------X-B-o-B----X----o-?---X-M-XBX-------?-----------M----o-M---B--X-?---MM-X---X-B--X--------XX----------X----o-B---?-X-----oo-
-M-----------B-BE---B---X---XoX-M--X-E-o--o--X-------------X------------oX----------X----?--Xo--B-------o-X--------------?-----B--------------XX---X----Xo-?----E----o---------o--------o-----X--BX-----
-----o----------X------M-X--o----MB-X?-X------X---X-?X-XX------X-X--XX--------------------Mo----------X-------?----o--X---?oM-X----M---M-------BXMX-X-M-----X---X-----o---??-o--------oX----oX----B--M-v
------X-----------X-X-------------o------------MB-----oo--------------------?o-------o------?MX---X-------o----o-XX----o------------MX--B----------XX--XB---oX--XB---------------X--------------------Xf
--ooMX-----X---X-----X---Xo-----?--o---X--o-----o-X-----------B---------------?o---X-o-ooX-----o--o-----X-o----------------X------------X-----------------X--------Mo--o----XX-----XM?----XX--X--XX-XMXf
-B----X---oX---X-B----------o----XB--B-------BX?------M------X----B-?-X-----?----M-------X?-----------------X-M----B---M---------------o---------o--XX------------------------o--------oM---X-X--------f
---X-X---o----M-X-MX-M--Xo-M--M---------o-------B--X---X---oM-----------------o------------oX---?-----X---------------------?-oX--X----XX--o-X---------o---B---X---o-o----o--?----------------------X--f
-----X---B-XX----------X------------B----o--T-----------X-M---X--oX--------M-X-------B--------M--M-X---X--B------BX-----Xo-------T----X--------X------X---?----------Xo----o-----------o-M---XX--X-----f
-------B---------M---------?-X?-------------|-------X-------XX----XM----X--------oMo--------------------?--M-X-MMXo--------o--o--|------M--X-?----M-X-o----X--?--X-----?o--o--X------------X------X----f
m--BX---------------------------------------X--------------------o----o------X-------X----------------X--------------XX--------X-X-Xoo---X----------o---oo-X------o-------------Xo--X-----oX----X-XX-XXX
XX-XXXXX-XXXX-XX-XXXXXXXXXXXXXXXXXX-XXXX-XXXX-XXXXXXXX-XXXXXXXXXXXXXXXXXXXXXXXXXXXXXX-XXXXX-XXXXXXX-XXXXXXXXXX-X-XXXXXXXXXXXXXXXXXXXXXXXXXXXXXXXXXXXXXXXXXXXXXXXXXXXXXXXXXXXXXXXXXXXXXXXXXXXXXXXXXXXXXXX
