--------------------------------------------------------------------------------------------------------------------------------------------------------------------------------------------------------
--------------------------------------------------------------------------------------------------------------------------------------------------------------------------------------------------------
--------------------------------------------------------------------------------------------------------------------------------------------------------------------------------------------------------
-----oM---o---Mo?----o--X-B------oX---o---X-----M-XX?o-X---------oXM?--------oX-B-----XM----X---------------X----X--X--XX-?-M----XX?B--X------------B--------------oX---?--B--o----oX--X------Mo---X----
-M---------------------------?-------M-B----?---------X---X-X--------o--X-X--X---?MX-----X-X---?--M---?-o-X--MX---M--oBX---------------------o-X-o----?BX---o----X-------------o--------?-??---oX-B---?-
-----BXoX--X-X----Bo-X--o-B---X----o--------------------M-X--M------oX-X----?--X------?-----o---X---o---oo-X---B---B--------XB----o--X-BX----Xo------------o---M------M--o--X-B----B---------------Mo---
--?------X----------o--oo----?-?X-------?---X------------------?----X----------X---------M---BX---X---X------XXo--Xo-------X-o--o?--o----M------o---X------X--------M--------X--------M-----?o--------?-
----o-----B--o--o---XB----?----------Xo--MMX-------XM---X--X------------X--o------Moo--X----?----X----oX-B----------oX--Xo--------------------M?-----X-o--X----o---------o-------------------B-o---o---v
----------oB----X-o---o------------X-X-----------o----BM---o-M----M--B----MX------------X------o--o-X---M----o--X-----?--------?-oB--------X----o--XX--X----M--X--------o---X-----X--BX---------------Xf
------M-----?oo-----X-----X--oXo-BX---------B-X-X-----------------------X------o-X-----------o-X-M-?-----X-oBX---X-----Mo---------o-XB------?X---XM-B--------o?--o--oM-o---B---X-o-o---?XX--o-o---B--X-f
---------X---------o---B-o-o-------------------o---XoM---------o----oXXX-XE---o----o-BX---B-----------o?-X-------X------o--------B-----?-------------------------------o?----oX---X------o-o-------X---f
--?---------oX---?----o------X---------------B---o--------o-----o----X---o?o------------o------XX--oM-----------M----o--------X----o-?--o--o---XX---?o-----------o---o----X---X----XM-----------X--B-Bof
------Mo-oB----E---------o-----M--------o------o----?o-----X--X-o--BX--o-----X---o---XXo--oX-o-------------?--X-----X---X---------oX-----XB--Bo--oo----o-----o---------o-B---o--X----B---X----X--X-----f
--------o-BM---X-B-X-B------oo--B-----o-XBoX------o--o-o-XX----o--oX----X--o------X-BB------------------oo---o-X-?-X-XM-----M-------X------o----oB----X-------o-------M---X-----BX-----XX--X-X----X-XX-f
m------X------X------------X------o-------X------oXX-X--------------X---X---X----oXo---XX-------------ooX-X------------X-----X--X--------oBo-X-X----o-o---XX--X-----X--X-----X---X-X-------B--oX--X---XX
XXXXXXXXXXXXXXXXX-XXXXXXXXXXX-X-XXXXXXXXXXXXXXXXXXXXXXXXXX-XX-XX-XX-XXXXXXXXXXXXXXXXX-XXXXXXXXXX-XXX-XXXXXXXXXXXXX-XXXXXXXXXXXXXXXXXXXXXXXXXXXXXXXXXXXXXXXXXXXXXXXXXXXXXXXXXXXXXXXXXXXXXXXXXXXXXXXXXXXXX
