--------------------------------------------------------------------------------------------------------------------------------------------------------------------------------------------------------
--------------------------------------------------------------------------------------------------------------------------------------------------------------------------------------------------------
--------------------------------------------------------------------------------------------------------------------------------------------------------------------------------------------------------
---oo----o-o-------?---o----?--------------X--X--M----X-oX------?-o--X-oo---------------oXB------o--------X-----?X--oBM------------X--BM---o-X--------------X-M------oo?-M--BM-o--X?X--Xo-X-----o-M-----
-X----B----o??o---------BM---------------------------X-X--B---?-------------X-o---M--M-B---X-X--------o-----X-------------------X---X----X--------o-----XXB-----M--?----------M-----------XB---o----M---
-----X----X---------------o---X--X----?-X--o--MB---o-----Xo----?---X-----X----XX--E--------o--X--X-X----M-----o-----o--?-X--------oX--B-------o-o-XX-----X------------oXM--B-----------------X-oX-----M-
---B-----X-o-----------o----o-------X-------X---BX------X--XM----------?----M--X-??-?-X-o------X--B---?---o---------------o-?--X---------X-BM------oB--------BX--B--?X-----o-----X--M------oX-----------
------B-----X----o---------X-MX----XX------------------X------------------B------------------XX--M-X-------M----------X-M------------X--------M-------X-X------------X-oXoo---X--------oM-----X--------v
-M-o-------X----------?----------M---------Xo-X------Xo-------B-X-?-o-------------MM-----XX-------?-oB------Mo---MX-X------o-----?-----o-oB?----M-o--M-------------X----X-BM?-----X----------?-----X--Xf
---oBoM------X--o--X-------B-----------X-o-o----X--o-----------X-----?--o--X-----------------o--?------XXM-----------oX----o------X--B--X-----X----B---XB--------------------o---------o-------X---X?B-f
----X--o----M----E---oMM-B-----------oo------ooXX-----------?o?--o-------X?-XB-X----------?--o---X-?-oX---?B---X-------X----M---X----------??o-------o-------------?-XB---Xo--X-----M-----X--o--X------f
---o-----------BMX------M-----B-X-----------o-----X---X?--X-------o---o----X------XX?--oo---o-------X--X---X---------M-------------M-----o----X?-------o--o-o-M--------M--X-----M------oXX-o----o-B---Xf
--o----------------o-------?M?XX-----B-B?-----?-X-B----------E--M-XX-B----X--o--Xo---M---X---------o------------XXMo----M---B--X-------------------X--X-?X--X---?----------?-----B----o------oX------XBf
-----XX--o--------o-----X------o-----------M----------?--o-XXB---o--B----------?-X--------X--M--X-------------?X---oX-B------X------o-o---B---------X-----o?------B-?---o----X-o---M-X--X----X-X-----X-f
m--o--X---X---------------------X-----------XX------o------------------XX-------------B---B------X-------X-----X------B----------o--X---------------o--------o----------B-o-o--oB-------X--X-X-Xo---X-XX
X-XXXXXXX-XXXXXXXXXXX-XXXXXXXXXXXXXXXXXXXXXXXXXXXXXXX-XXXX-XXXXXXXXXXXX-XX--XXXX-XXXXXX-XXXXX-XXXXX-XXXXXXXXXXXXXXXXXXXX--XXX-XXXXXXXXXXXXXXXXXXXXXXXXXXXXXXXXXXXXXXXXXXXXXXXXXXXXXXXXXXXXXXXXXXXXXXXXXX
