--------------------------------------------------------------------------------------------------------------------------------------------------------------------------------------------------------
--------------------------------------------------------------------------------------------------------------------------------------------------------------------------------------------------------
--------------------------------------------------------------------------------------------------------------------------------------------------------------------------------------------------------
---------B---------------------------------------------------X-------------M-B------X?-----------------BX-------------------?--------------X---X---X----------X-X-----------?---------------------------
--------------------------------------oX--------------o----X-----M----X----------?------?----------?--?-o--X-----------------------M--o-X-------------M----------------X-----------?------X---------o---
-------?-----X-----X-?-------?-X------X--------------XB-------?----------?-?-----------------X-------?----M-Bo--------?--X-o--------X-X------------------X---o----X---?----M----------X-----------------
----------oM--------------------o---M-----------------M---------------------o--------------------?--------------o------X-----------?M--?--?---------------X------------------------o-X------M------o----
-----X---X------------?------M----?X---o------M----------?----M----o-?--M---X-----o-----------M--------------------X-------------------X-----------------------------X--BX--M-----B--------------B-----v
------------?-------------?------M-----M---------X---B----M----------------X----X---------------M---o----------X--------X---MX---------------------XB---------------M--------------B------o--?---------f
-----------M----------------M----o-M----B--X-----------?-------------------------X--X---------M------?--------------------------X--------B?--------?----------M----M--------------M--------------X--B--f
-o--B---o------------------M----------------------------------B------------X---o------------o------M------------------------------------------------o-----------------------X-X-----------------M?-o---f
-------------X-X-o-----BX----o-X---X---------o--------X--X---XX--------X-?--X---M-XX-----M----------------X-------------o---X-----------------------M--------XM---M----------------B--------X?-------?-f
------?---------------o-------?---------o-----X---M---------o--X--------X--------B-------------------------Xo---------------------------o-------B--------X-M-M------?--M-----X-----M------o--------T---f
-------------------------------------------B------------X-----------------------M-----------B-M------------------?----?-----------E-B---X------------X----B--B--M-?------?-B-------------X----X----|--?f
m------------------o-------------------------------------------------------------------------------------------B-----------------------o------------------B-o------------------------X--X-----X----X---X
XX-XXXXXX-XXXXXX-XXXXX-XXXXXXXXXX--XXX-XXXXXXXXXXXXXXXXXXX-X-XXXX--XXXX-XXX-XXXXXXXXXXXXXXXXXXXXXXXXXXX-XXX-XXXXXXXXXXXX-XXXXX--XXXXXXXXXXXXXXXXXXXXXXXXXXXXXXXXXXXXXXXXXXXXXXXXXXXXXXXXXXXXXXXXXXXXXXXX
