--------------------------------------------------------------------------------------------------------------------------------------------------------------------------------------------------------
--------------------------------------------------------------------------------------------------------------------------------------------------------------------------------------------------------
--------------------------------------------------------------------------------------------------------------------------------------------------------------------------------------------------------
-----------o------XX?M----X-?-o-----M--X---X---MX------X-o-o----?-Bo-----M---X-------XB---B-X--?---XX-----o---EXX----o--X------------------------X----B-----o---------o-----B-o------X--oX---------o?---
------B------X-------------------Xo--M--o?---------X-B---X--o----X-o--------------M--------X-X--------BM-X---?X-Xo-------X-BX-------o---M----?--o-X?---o?-B-X--------------X---o----X--o----------X--o--
----------X-M--X------X---o-----------------------o-B---------X?--------?o--X-X---------B--o---M-----------M---M-------X------oXo--X-XB---X---o--------------?--X----Xo----B--------X------X-o-o-o--o---
-o-B----------B---------o---o----B-----------X---------X-X-XM--------o-------------Bo--X------------M---------------o----B--?MXX-----o---M----------------?---XX---X-X--X-M-XX---?------X--o------------
---o--------X----X-----o--?--MX-X-X------X?------oB-----------------X----oM----?------Xo------X-----------X-------------XXX-----o--M--X-----------X-o------B------X-M---X---------o--X---?-------oX----v
--------X-Mo-----------------------Xo-------------------XMX?--B-X---------------o--o--X--------X-o---B-------o-o--X----X---XX-oo-?-----X-X----M-M--------------------------?-o--B------X---X-----oo---of
----B-o--------------B?---oo---X-----?---X-----------o------------------o-----------B---M----------o---XX-----M--?--??B-X--o----------?-X---------o---------Mo?X-X-------B--?--------o---XX------------f
----X-X-----M---o-M-----?---?----------o-----o--------?----------X--X-----M----------Xo----o-X-----------o-----o------X---M-o---X------------o------MB----------M--B-B-----------M--B--------o---B-X-X-f
-oo-------------o---M-M-------B-XX-B------B-o-----XX------X?----o-X---X----------B--X--o------?---------X-M---------X---o-------------------o--?-o-----B-BB-------B----X-------B------M------X----B-X-Xf
----Xo---o-M------B---------oXXX--o----B--o-------X----------o-----X--X----------X-------------BXX-o-M-----B?-X-------X---M-B------oX-X-------------o-o----o----------o-o-------o---M----X--M-----B----f
--M---X-X----o--o---?-----X----------E---X--X--XB--X----X---?B---o-----?-------------BX-B-X---X----o-----------X-oX-------------------o-------E-----X--oM--B-o------X--------o-o------X---X----X------Xf
m----------o-----o----------o---X----BX-o-----------------X-------X-o------------X--o--B------------------o---------------X---------X---------X---B-----------o----X--o---o------X-X---o--XXB--X-------X
XX-XXX-XXXXXXXX-XXXXXXX--X-XX-XXXXXXXXX-XXXXXXXXXXXX-XXXXXXXXX-XXXXXXXXXXXXXXXXXXXXXXXXXX-XXX-XXX-XXXX-XXXXXXXXXXXXX-X-XXXX-XX-XXXXXXXXXXXXXXXXXXXXXXXXXXXXXXXXXXXXXXXXXXXXXXXXXXXXXXXXXXXXXXXXXXXXXXXXX
