--------------------------------------------------------------------------------------------------------------------------------------------------------------------------------------------------------
--------------------------------------------------------------------------------------------------------------------------------------------------------------------------------------------------------
--------------------------------------------------------------------------------------------------------------------------------------------------------------------------------------------------------
--M---X-----X----XX---oo---B--o---M---BX---Xo-X---oo-------oo-------XX-----X---B---------M------oX--------o-----M-B---------------?---B---X--M--M-----------M?------M----------o-o--XX-------B--X-BMXX--
----X--?--MB-o-----------X---------o----------------XX--o-B---X---------X---X--oX------B--oX-X-?------------X-X--Bo-X----------X---------B----------------------X-o------X-----------B--------B-------?-
-----X---------B-------o--o-B----?----o----X-?M----o-----X------XoX---oX-X-?-----------o-B-XM-------------X----M---M-----M---?X-o--X?-B--BX---X--B----X-X----o---------X-----------o-----X-------o--B---
-M--o-?X-X----XX--X-----?-oX------XEo--M-X----------------MX-------------------X--------------X---B-B---X-------------X---X----X--?--o------X--------o--------X--B---o-------X--XX--o-------X--B----X---
--------------o-o---------------X--X------M----o-?------?----o-M?-------X----X---MB---B---oo--X---BB--B-o--X----X----o-----------------------------X----X----X-------XM----------------B--------------Xv
---o---?X----o----------------M--M-X----o--Xo-X---M----------B-----M-------M-----------B----X------o---------X------M-X--B-B-X-----?---o-----o----o--M----M-o-M---------XoB-------X-------XX-----------f
-X---o-----X-------------------o---------o-----X---o--------X---------X--------------o---?------X---X--?---------M-----M------?-----o---B-----X--------o----------o-?--X----Xo---oo-----?---X------X---f
-----oX--------------------B------X--ooX-----M?XB-?-o----BM--o-------Bo---o-XM--------B------------------o--o--?----------------------X---B-----M----?--------XB--------------M-----------------X?-----f
-M----------X-XX-X?------XXX--B-X--------------------Mo-------B-B-o-o----X-M-----B-M------XXo-----X---o------------X----o-ooXM---------M----o----X-----o-o---?B-?----X-----X------------X--o------X-o--f
--o-Bo--o----X-----o-o--oX----X------?----o-----X-B------------T---X----M----oX---------------X--X-o---B--o-?---XMM-----o--o---X--------X------?o---------Mo-----o-B---X---B---X-----X-X------------X-Xf
---B----X---X--o---X-------?oB-X------------------oM--?-B------|-o---o---------o-X----X-----X?-X-----X--M-----MX---?---o-----M?--------------M------MB-XB-----------M---Mo-----------------X-X-X-----X-f
m--------XX-----------------------------ooo--X--o----------X---X-X--o-X-X-B----------------------X----------------------o-------------o------------------X---oo-------X-------B-B----X----X--B-X-----B-X
X-XXXXXXXXXXXXXXXXXXXX-X-XXX-XX-XXXXXXXXXXXXXXXXXXXXXXXXXXXXXXXXXX-XX-XX-XXXXXXXXXXXXXXXX--XXXXXXXXXXXXXXXXXXXXXXXX-XXXXX--XXX-XXXXXXXXXXXXXXXXXXXXXXXXXXXXXXXXXXXXXXXXXXXXXXXXXXXXXXXXXXXXXXXXXXXXXXXXX
