--------------------------------------------------------------------------------------------------------------------------------------------------------------------------------------------------------
--------------------------------------------------------------------------------------------------------------------------------------------------------------------------------------------------------
--------------------------------------------------------------------------------------------------------------------------------------------------------------------------------------------------------
--X-B-E--------B--o--M-------------oXoB--------?-o---BX-----X-------------X-----?--oo-------------o--------XX--oM------o-------B-------------X----X-----?---------X---X-M?XXB---------X-----oo-----M-M--
------X-M-B---XX------o----XM?-X------X-----M---X--X-----XB--o---------------X---X----X-X----M----------------X----o--o---------------o------------X-X--------B---o?-----------------X----o--oXXo-------
---oX----M--X------------X--------XoE--X-B?------------o-------Xo-----X-----B------X-M-o------Xoo?-XXo-X-X---------Bo---X-X--M----X--M--X--------M--------?----M-----------o---?oX---X-------------X-XB-
-----------------------------o------B-?------o---XX----oB---------------o--MX-X-----------------------M-------?-----------------?X------o-----------o---------------o-X---o-----BXo----B--X------B-X----
-----Mo--XBB-----M-B----MM-----X-?-----------o-----X----o--o---------?B?XM-----X--------X-oX---B---------oBoB------------X--X--------X---MB--------X----o-?-----------X--M-----o---X-MM-------o---B----v
-oo------------------------------------?-?----X---o--------------o----------B--XM---o--o------X-o----------X--XX---oX--------X--X-B---------M--o-M-X-------------X-----X--XXB--------------o-X-------oXf
-----------X-Bo----X-----o--B--X-o---o-E----B--XX-----Xo-X?--------------oo---M----M----o--X-----X?-o--X-M---X-----X----E-------------?o----------M---Xo--o-o--BXX---?--M---XB---E-----Xo---X-X---X----f
-oMXM----XX------M-o-----------X--o--X-B------Xo------XX-----B-X-X----oB--------??-----o-X-----M--------------M-?-B----XX----?-----------------------X--------X---?--------------B-------M--X--Xo------f
----------o----X----B?--o-------o-------X-?-X---?-o--o--o--o---X------------?------X------------oMXB------o---------------?------o---o--?-o-X-o-------------?------o--o------X-------?---------o-------f
-X--XX-------M-o--o---------X-o---B--o----------------?-------o-X------------X----------X--o--X----B--M-o----XM--X--oooo-----Xo-o---------o--X----------o------------X-----------Xo-------X---o----X-X-f
--X---X----B--o-?--X-o----B----?-------M---?-?--X--oM--o-----------------M--------B--------X-X-X----X-----------------------?--------o-----o------M---o-o-----?-------X----M--X--------XXo---------XX--f
m----o-----X-B------------X----------X---------------------B---------X----------oX-X---Xo------X-----------------------XX---------o-XX------B-o--------XX--X----X--X--------------X---B-ooX--XX---XXXB-X
XXXXXXXXXXXXXXX-XXX-XXXXXXXXXXXXXXXXXXXX-XXXXX-XXX--XXXXXXXXXXXXX-XX-XX-XXX-X-XXXXXXXXXXXXXXXXXXXX-XXX-XXXXXXXXXX-XXXXXXXXXXXXXXXXXXXXXXXXXXXXXXXXXXXXXXXXXXXXXXXXXXXXXXXXXXXXXXXXXXXXXXXXXXXXXXXXXXXXXX
