--------------------------------------------------------------------------------------------------------------------------------------------------------------------------------------------------------
--------------------------------------------------------------------------------------------------------------------------------------------------------------------------------------------------------
--------------------------------------------------------------------------------------------------------------------------------------------------------------------------------------------------------
------?X--?-o--------X-------o---MM------------M-----------X--X--o-XX--XX?----------------B?----------------o-?X---------------B-X----M-----XB-oo--------?-XM-------M--B--X--------------BB------o-Bo---
-Xo-----X----X------X------------------X---?-X------B-----------------o----?--------o--------------X------?------B-------X--M-o-B--o---?------o--oo--?-----------o-----------M-----B--------------?---X-
------?X-XB------X---X--B----o--B-------X---XX-B-----o--------M---X---o-------?--------?-?o----X---oX-o-M-------------o--------X-----X---o-----X---?------------oX-B-Mo--XM----?-----XX-o-XoX------BX---
--------------BXX-----o---MX---------M----M?------------B---B-----o---------X----o--B------MX---XM---B--------?--XM-----X---?-B-------------X-o---------M--?--X---BX--X--------------B-----X------------
--M-----o-oo--o--M--------------M-----M------X--B--------?---Xo------o----------o--------X----X---o--B-----o----o-------------X--o------B-X----o---------------o--o-?-------------o------X---o-----B-o-v
-------XBX--M--M---?------M-------------X------X------o----------o--X----E-X---o--B---------------o-o------o-------o----MX-o?--X--------------o---o-----X--X---------o-M------o-X-------o-X---X----B---f
---------------------------------XM-X-Xo-o--------------BB-----X----o-o--X----X--o--oo-M----?------?X----B--MX--M--X----------M--X-----?MM-o---oXoXoX--X--BX-X-----------------X-----X------X--B--M----f
---XoB----o-----M--o---oM----------X----B---Bo-o--X-X-------X---o-o--------o-------------?o---X-X---------?------X-------------XX------------------------X--X-----X-----o----o--------X--o?X-X-------oof
--------X--B-o------------------------------X------o----X-o-XB-B-?-------o-o?---XX---X-o----X--?-M--?M----------------o--XX-?------M---------X-----X-X------X------------M-----MM---M------------------f
-X---?X------------B-XMX--------X-----------------X------o--------M--o-------ooB-----B---------------------B--?B----------------B-----o---------o---------X?-X------o-o-----o----------?--X---B?-B-----f
-------X---X-o---oMX-----?M--XB-B---------X-----------MX--?oX--------XBBM--M----B------X--X---------X?o-BM-------X---o--B------------X-------o--oB?---B-------o---------B-X-BXBB-o-o------X--X--oB-----f
m---X---Bo-X---X-----X-------------X--B-------X----o-------------------------------X----X--o----X----------o----X----Xo----B-------------------X---------Xo-oB-X---X-----X----oX-----B----X--X-o---X--BX
XXXXXXX-XXXXXXXXXXXX--X-X-XXXXXXXXXXXXXXXXXXXXXXXXXXXXXXXXXXXXXXX-XXXXXXXXX-XXXXX-XXXX-XXXXXXXXXXXXXXXX--X-XXXXXXXXXX-XXXXXXXX-XXXXXXXXXXXXXXXXXXXXXXXXXXXXXXXXXXXXXXXXXXXXXXXXXXXXXXXXXXXXXXXXXXXXXXXXX
