--------------------------------------------------------------------------------------------------------------------------------------------------------------------------------------------------------
--------------------------------------------------------------------------------------------------------------------------------------------------------------------------------------------------------
--------------------------------------------------------------------------------------------------------------------------------------------------------------------------------------------------------
------X--X-----?--------------X?-X-------X------X-X-X---------o----o-------------X---X------?-----------X-------B--M----M--o-X-o----E--oM------?------------B----------?---M------?---X----X------------
-----o--------------X--B-M--M--------?----------------o-?-X--B---B--?o-----------------------X------X-B-----M----X----------------?-BM---o-------M-?------------X-------X-------------o?-?--X--?-o-B-M--
--M-B-------MX?--M----------------X-----XBoM-X-oX--Xo-----------------X-----Xo---X---?--M----X-----B----M-------?-??-----?---------------o--B--------o------X-X--o-------XXX---X---X---------X--------X-
---X--o-----------M-?--X---o--X-----Xo--o---?----?------------?---oo-oBX-X----------------o---------M----X----------------o--------X-B-------o-----M----M--o-------MB-------------o---MX---?--?-o--?X---
-?------M----o-----------------X-------o-----------------------------------M?---------M---------X----X-o-----o------o-M-oX-----?X---oo-MMBB----o------M--X--X--------------o--------X--XM--------o-----v
-----o-------X-M---M---------o--X------X-X--B-Bo-BM-B--M--X----------X--------o--------------------------o------?-M----B---o-o---X--o----------Xo--X---------M------o-oX--oo--M----------?--X-----o----f
-?-B----o-----------M--X---X---------------?------------X-B---M--o-?--?----------?---X-?-----X-----X----X----M-------o----?-------M----?---?---------------------X-MB-o--------X-X--B----------X--X----f
--X-B-----------------?--B?---------o--XB-------B?----oM-o--?-------------------------------X---------X----------X-------------------o--o----o---?-o------------?o-------oB--?X--B--------o------------f
-----M----X------MM-X----------------------o--?---------------?M-----X--------o-----M---------B------o---B---X------X---o-----X--------?o-----B-------M---X----------------M---X?-X----M----o?--------Mf
------X-?--------------B---M--------o----------X--X----X--------o--------X-------o-----M-X---------------------o----o-------oo-B--?-------MBX--------------M-oBX----X---------X-----------o---oX----B--f
-------------------M-----X-------M---M-?o-?--------X----M----?--o----?---------?---o------------o-?------B--M-----------X-BB-------X--X---------o-----X----------------?--oX-X--o----X-MX-------XB-----f
m----o--------B-X----B--X----------o-------------X------------X--X-----X-----------o------X---------------B---X-----XX-X----------X-X---------------B--o-XX--------X------X---------X-----X-----X-B--oXX
X-XXXXXXXXXXXXXXXXXXXXXXXXXXXXXXXXXXXXXXXXXXXXXXXXXXXX-XXXXXXXXXXXXXXXXXX-XXXXXXXXXXXXX-XXXXXXXX-X-XXX-XXXXXXXXXX-XXXXXXXXXXXXX-XXXXXXXXXXXXXXXXXXXXXXXXXXXXXXXXXXXXXXXXXXXXXXXXXXXXXXXXXXXXXXXXXXXXXXXX
