--------------------------------------------------------------------------------------------------------------------------------------------------------------------------------------------------------
--------------------------------------------------------------------------------------------------------------------------------------------------------------------------------------------------------
--------------------------------------------------------------------------------------------------------------------------------------------------------------------------------------------------------
--------------------------------------------------------------------------------------------------------------------------------------------------------------------------------------------------------
--------------------------------------------------------------------------------------------------------------------------------------------------------------------------------------------------------
--------------------------------------------------------------------------------------------------------------------------------------------------------------------------------------------------------
-------------------------------------------------------------------------------------------------------------------------------------------------------------------------------------------------------f
--------------------------------------------------------------------------------------------------------------------------------------------------------------------------------------------------------
m------------------------X-----X--------X-------------XXX------------------X---------------X-----------X---------X------X------------X--------------------X--------------------------------------------X
X-------------------X---------X--------X--X------------X-X------X-------X---------------------------------X--X---X------XX---XX------X-----X----------------X----------X-X------X------X---------------X
-------X--X-X---------------X--X---X----X--XX---X-X--XX-X-----X----X--X--X-X-X----X-------X--------XX----X--------X-XX-------------------------------X----X---------X-XX--X-X------------X--X------X---v
------X--------X---XX---X----X-----XX---X---X---------XXX--X-X-XX-XX--XXX-X---XX--X--X-XX-X---XXXXXX------X---X-XXXXX------XXXX---X-X-X---XX-XX---X----X-------XX----X-XX-X---X----X-----X-----X-----X-f
-----XX----XX-----------------XXX--X-X---XX--------X---------------X---XX-XX--------X-X-X---XX-X-------XX--X--X---------XXXXX---XXX--------XXX-X-X-XXX---------X--X-----------------XX---X-------XXX-X-f
-------------------X---------------X------------X-X--------------------X-X-------------------------X-----------X----X--------------------------------------------------------X------------X------------f
-------------------------------------------------------------------------------------------------------------------------------------------------------------------------------------------------------f
-------------------------------------------------------------------------------------------------------------------------------------------------------------------------------------------------------f
