--------------------------------------------------------------------------------------------------------------------------------------------------------------------------------------------------------
--------------------------------------------------------------------------------------------------------------------------------------------------------------------------------------------------------
--------------------------------------------------------------------------------------------------------------------------------------------------------------------------------------------------------
----M---------------?o----------X-X--------------M---oM--------?-----o------?---o---o-M-----X--?-----------------E-??B--------X------?-------X--o---X----?--o---X----o--M---X--X----?--------?B-o--M?-o-
--------------X---------X-------------------X-----X----------------M----X----M--X-o-------?-------M-MXX--------o-?-----?----------------oM----?--X-B-B---------------------X------B----X-X--------------
-M--X---M--XX--X-------?-B--X-B-X--------XB------------B-----X-----------B----?--X--X-----------------B?----o--------------------------o---Bo---------o----X-B---B-----?----oX--X?----------o-B---------
----------?--X--XB--------B----------------X------------X--?-----M---X-o----------------B-----------o------o---o---M-----X-B-o-?----?-M-------B---------X-------X---M---B----------XX-----------------o-
-----X-----?X--X---MB----------M---X---M----X---------oo-----M------------------?----?-------X-o-M?--Bo--------X----?------------------oB-----B---o-o--o---------o---M--X-----X-M-----------o--B--o----v
---?-------------------------------X-?---oM----X-?-------o-----Xoo-------X------------------B---------X-----------------XX---X----?--------X------X--o----B-o--o--M-------o-o------M---------------o---f
----?--------X-------------B?--?------?--------------X---X---o------M-?oX----o-------------o-------?---------M-M-o--------oM---X----M-----M--M-X-B-?----------------M--X---?----XX--BX--XB--------X---Xf
----------X--------------B-------------o--oB------------------M--X---------------E---X-------M---X--------o-----X----o---------------------o-----------B-X------------------------o---------B--------o-f
-----XX-XXX-XXXX-X-X-Xoo-X---XoX---o--X-?X-o-?X-M--XX-X-?oXXX-----MX-X--X?-X--X-XBXXXB-X--X---XBX-M--X-XX--X--oXo-XX-X--oXXX--X---M--X--------------M----X-E-o--o----M------------------X--?--------oo-f
-o-oo---------E--X-------------o----o------------------------M-o-------o------X-X-------------------------B--o----------------XX-------o---o---o-------?--BMM------M---------?-----X---o-----X-----?---f
---------X----X-M-?-----?--?----X-----------B-----------o--------B-----X------------o-----?-------B---X----X---M-------o-----X-----?X-----M---X---XBX--------o---?-E---?X-----o-----B--XM----B-X----X--f
m------X-----X-------------------X---X------------------X----------------o--X-----o-X-----------oB----------------o--------X---------------X-oo------o-o----X--X---B----------Xo-X-o-------o-X--XX-X---X
XXXXXXXXXX-XXXXX-XXXXXXXXXXXXX-XXX-XXXXXXXXXXXX-X-XXX-XXXXXXXXXXXXX--XXXXXXXXXXXXXXXXXXX-XXXXXXXXXXXXXXXX-XXXXXXXXXXXXXXXXXXXXXXXXXXXXXXXXXXXXXXXXXXXXXXXXXXXXXXXXXXXXXXXXXXXXXXXXXXXXXXXXXXXXXXXXXXXXXX
