--------------------------------------------------------------------------------------------------------------------------------------------------------------------------------------------------------
--------------------------------------------------------------------------------------------------------------------------------------------------------------------------------------------------------
--------------------------------------------------------------------------------------------------------------------------------------------------------------------------------------------------------
------oo--X-XM--?--o-X--M--B---o--X---oo--B--?---------X--------M-----X---------B------X-----X--------M-----X----X-o-MXX-X-------XX??X-X---?---M----M----------X---oXM-----B-Xo----X-X-X------M----XB---
-M--XX---M---------------X---X-X---X-----o--------------X-X-X-----------X---------------X-----o---?----------X-oXB---------B------------o----o---o---o----M-o-----------------XB----M---?-------------?-
--Xo-B---E---X---o-oBo-Xo-X---M-----o------X--B--------o---B-----X-BoX-X----o-----o-B-?X---ooo--X---o----------B---o------o----o--oX-X-M-oB---M---X----o---o---XM-------Xo--X-----X---?------B---X------
--X-X--XXX----------o-X---------X------X----B-------------?---M?-XX-X----------XM-------------o-------X-----------Xo-----XoXB-X-----o--------------XX?--o---X-?----oM--o--X--Xo-----------?-XB--o-----?-
----o--------o--oX-o-B--------X----------?Mo--o---MM-B-----o---------o--X----------oo----BX------X-X--o----X--------o-M-?o--------------------X-o------oX----------------o------B------o---Xo-----XoX--v
---o---o--o-MX------------o-B--XM--X-X----------------B------o-M---------XX---oo-XM-------X--X-?--o--X--M-X-o---X?---------B-----o------?-------E--X---X------------------M-X-----X--BX-------X----X---f
--o--X--X-----o-------------------?-X-X--Xo-X----------------o--o----------------------------o---o---X---o---X-----X-----------X--o--B-------X?-XX---X-------?-------XM----B-----o-o---?B---oMo---?----f
-?---o-BX----o----oo-----o---------o---oo--oX--o-----M---------o-MX-o-X--X--XX--B----o-------------B--o?-X-----------------------B-------X--X----X-------X---------o----o-X--o--X-X-----oo-o----X------f
----?-------X-?--o----o------X-----X-----o---X---o-o---X-o---X-----------oo------X--o-o--oX-?------E----?----------M-o---X----X----o-?---------X--X--o-----M-----o------------X?---Xo------------o-B---f
-------M-oo---------X----o-M---------T--o------------o-----oX---oB--XB---------------XB---o--oX----B----------X-----X---X---X------------X?--BX-o----X-o----M---------X----B-o-------XXM---X---------B-f
-o-o-o--o----o-X-X-X------------B----|o-X------------o---X---B----------X--o--o---X--B-------------------o---o-B-?XX---X-------X---X----B--X--XXo------------oo--------EX------oB--B-X--X--X-?-o-XX----f
m------X---o---X------------o----B---X----X------------o---------o--X---XXo-X------o--XXX---------X---o----X-----------X-----X--X-------Bo-oB--------Xo--X-X--Xoo---X--X-----Xo--X-X--o-o--B--oX--X---XX
XXXXXXXXXX-XXXXXXXXXXXXXXXXXXXXXXXXX-X-X-X-XXXXXXXX-XXXX-XXXX-X-XXX-XXXXXXXXXXXXXXXXXXXXXXXXX-XXXXXXXXXXXXXXXX-X-X-XXXXXX-X-XXXXXXXXXXXXXXXXXXXXXXXXXXXXXXXXXXXXXXXXXXXXXXXXXXXXXXXXXXXXXXXXXXXXXXXXXXXX
