--------------------------------------------------------------------------------------------------------------------------------------------------------------------------------------------------------
--------------------------------------------------------------------------------------------------------------------------------------------------------------------------------------------------------
--------------------------------------------------------------------------------------------------------------------------------------------------------------------------------------------------------
--o------------------X-------X------------------XoM-X---M--------?-----M----------?-------------------E------------X-----B-------------oX--?--M--o--------o-----X---X-----------M--------o--o---o-------
-------------o-------o----------X---------X-----------o---?-------XM----------------------------------?-o--?-----X--o-Xo----X-X----M-M---------?---X----B------------X-----X----------------X-----------
----X-----XX------------X-X-------X-------------X----------X------------X------?XX--o-----oM-X-X--o----?X---------?--X-------XX---------o--X--------------o---X--?--B-----X----X-----------------B--o---
---X---o----o---o--------------M-----------?-------------X--o------?-----M--------?--M-------------------------o?----------?-------XX------o-----o-XX-X-----------B-------------X-o----?--------o--X----
-------------B-B--X-M---X----X-------M---o---?-----M-----------?----X-X----X-----------M---X-----------X---X------M-----oX--------E----------X-o-----B---------X--------o--o??-----M-?--------B-------Xv
--M-oM---------X-X----E-------X---------XX-----M------X-X-BX-X--o--?--X---X-----?--------MB-----X---X------o---X-----------o------X-M-X-----------o-----X-----------o-oB--M----o---------M---------X-M-f
--------o-B-----?-----?--B-?-----------------X--M-M-X---X-----X---------?-E-o---------------------o---------B---B---------------o------------?M---XX--Mo----M--o-----B---------X-X--------X----X-X-----f
--X------?---B-----M?---M-------M-B---oX------?--------------------------oM------X--?-------X---o------o-----X--o-o---E--------X--------o-------M--X---------------o----X----?M--B---oo---o-------o----f
---------------B----------X--o-------M---?o-B---?-----Xo-BM--------XBXX--------------o---------B--------o-X--X--------X-o--M----------------BMM----------X--X---------o--M---------M---o-B--MM------BB-f
--?----X--------X---o-----------------------------M-------------BE-----M----o-------M-------o-------B----M-----o-X-B----------oB--X---o--M-------o------o-----XX?-X-X---------------------o---X--X--B-Xf
------o-----M---X-----?----?------X--o----?-----------?-X--X?--E-?-?----X-M------Xo------?-------M---o----X----------M?------X-----X--X--------o-----M-o-----------B------o-XX--o----------XMo---B----Bf
m---X-X-----------------X---B--------------------------------oXX-------------------o--------------Xo-------------X-----X-------X---X-XXX-----X----X------XX-----X-XB------X-------------o----X--X----oXX
XX-XXXX--XXXXXXX-XXXXXXXXXXXXXXXXXXXXXXXX-XX-X-XXX-XXX-XXXXXXXXX-XXXXXXXXXXXXX-X-XXXXXX-XXXXXXX-XXXX-XXXXXXXXXXXXXXXXXXXXXXXXXXXXXXXXXXXXXXXXXXXXXXXXXXXXXXXXXXXXXXXXXXXXXXXXXXXXXXXXXXXXXXXXXXXXXXXXXXX
