--------------------------------------------------------------------------------------------------------------------------------------------------------------------------------------------------------
--------------------------------------------------------------------------------------------------------------------------------------------------------------------------------------------------------
--------------------------------------------------------------------------------------------------------------------------------------------------------------------------------------------------------
--------------------M---X------o-----------------M--------?--B---oXX------------X---o--------o----?---------M--?-----M------X----------o----------o-----B---B------X-M----------X-Mo-----o----X--X---o--
--M-?---------X---o--Xo-X--M--------?E---X----------X---M--M----?----o----o--XB---------BX-o-------------XX--------M----B--o--M--B----------oXo-o---X-------X-----B---B-------X---------X-B-------B-X---
------BX-X-------X-----B-----?-X-o---X---X--?o-X--------------X-----X--X------o----X---XB-----o------XXXBooXo--o-----ooo-------o------------o-----oX-----X------X-----X??------?----X-?--------o---X----
----X-B--o-------oM--XB-X---------oM----------------X-?----X---X-------o-------oo-----B---?-B---M-X--B-Xo-----X-----o-o-X---------X-M-?-B----X---X----------E-X--o-o-o-----o--------X----E--X-X---------
-----X------?-o-----------B----------XX---B---------o----------X--B--X--------M-o-?-----X----------M--------X------o-X-------o--B-------------------B-X-----X---?---M--------B--M--X-----X---o-?--o----v
--o-----B---------X-X-----------o-M--------o----?-B----------XB-----------XX-------M--B--?-M-M-------------o---oo--o-------M---o------o------------------XM---B---?---------------X--o--o--M?-----o----f
--B----X-B---B---M----B-Xo--?Xo------XMX-----MX----X-----B-----?--------o-----------?--X--------X-----X---M--M----------X--------X--M-X-------Xo--o---?------?--X----------M--X-B-X------B------M------f
------?---M--o-----MB--------------------M-X--B------------MX-----?-------?--X--?-------------Xo---------------X----X------Xo-M------------------------B-------------M------X----X----XX-X-------------f
---X----X--M---------oo--------?----X-----?-?-----oX---o------?-X--o--o-------M------------------o-Bo----------------M-M-X-------------B----o--o?XM?-o----B---?M?------X-X------o-o-----X-----X--X---MXf
--o---BB---------X----------------------X----o----X-?-----XXX--o-?-X---Mo----------o--------------------o---X--XX-o--------?-------------M----------X-X-?--------------X------------o----BX----X--o----f
---XB----B-B--------MX--o--X----Xoo------------o-----?M--X-o------X-?X----B---------X-----o---??-----------oX---B--oXBM-X-----------------Mo----X--------X---X------M-o--------B-X---X----BB---X------Xf
m----X---X----XB-----B---------------------B------X---------X--------o----o----Bo-------o-------------o------X----o-------X-XX--X------o----B---X---------------B----X-B-----------X----X-X-XX-X-----X-X
XXXXXXX-XXXXXXXX-XXXXXXXXXXXXXXXXXXXXXXXXXXXXX--XXXXXX-XXXXXXXX-XXXXXXX-XXXXX-XXXXXXXXXXX-XX-X-XXXXXX-XXXXXXXXXXX-XXXXXXXXXXXXXXXXXXXXXXXXXXXXXXXXXXXXXXXXXXXXXXXXXXXXXXXXXXXXXXXXXXXXXXXXXXXXXXXXXXXXXX
