--------------------------------------------------------------------------------------------------------------------------------------------------------------------------------------------------------
--------------------------------------------------------------------------------------------------------------------------------------------------------------------------------------------------------
--------------------------------------------------------------------------------------------------------------------------------------------------------------------------------------------------------
------X-------------X---?--BM--o------------------M-X-o----------X----X---------o---o-X----------------------X-?------o-------?X--------B-----B-----B----------o-X---o-X----------XoX-X-----X---------B-
---X---?---?--o-B--X-----M---------X-B-M-----oo-----XXX--------------------------X-----------o----Bo------B-------?X---ooM---------B-----oo-E---?-------Xo--------?-B-------?-X--X--X-B-?-B---X------MX-
--Bo-----o---X---X----------XB------------?----------------------X----X----X--XM--o---EB---X------------B--X---XX---X-o----?-----B-X--------XM---X-----------o--------o---------------------XoX-X-X-----
------Xo-o----o-X---?---o--?---X-----?--X------X-X---------B-------Mo-o?-B-------o-X--M---------o-X---M?------X--X----o-----X---o---M----------X-----o--X----oX---B---X-------------o----------X----B---
----X-o--------------o------MX----------------------------X-?B?--------------B--o---B---?B--B--oo--XX---o-----B--------B-----?X--------o-----------BX--------------------Xo---o-o-o---BBo?----X--------v
-------?---X----------?-------o-o---------oM--X---------------------------o---XX---------------X-----X-------X------o---------------?oo--------------M--?---M-------?-o-------XX-?-M--o------Xo------X-f
----B---------X-X-o----X-----?------o----------------M-o-----------B--M-XXX-----Bo-X--X-XB------Xo-----B------X---------X------o-o?------oB--o-----------------------o--------------------------------Xf
--------X----oB-----BM--M------------o---o-M---?--------X---B--------------------X-------o-X--Xo-----M-----MX---X?--X?M---o---o----X--------o---------XX---Mo--o-o-----B-M------------------------oB-M-f
--?----XX------X------o--oB-------?----------o--oM-o-M-o-----M--X-----X---BX-X-----X---X---B-------B-----?-------------o----?o-o----o--X--XM-----X-?----oo-----XX--?---------BM--o---------XB-X-X------f
-----X----------------B---------X-----X------X-----B----?-----X--X-----------ooo--o-----------------o--?------------------X------------------XX---------X----X?--?--------X?X---B--------X----------?Xof
--M----------?M---------------X-X---oXo-----B---o--------------------Xo--B------BoX----M---?----X--o-M---M-X---X----------------o--------MXo-B---B---------B------X---BB-----B----o----?X-B-------o---Xf
m------B-------oX--------oo----X-B----B----X--o------o-B-XX---------BX---X-----XoX-X-X---------------------XX-----XX-X---------X------B--------o-----------o---XX--X---oX---o-o-X--X----X-----X----oX--X
XXXXXXXX-XXXXXXXXXXX-XXXXXXXXX-XXXXXXXXXXXXXXXXXXXXX-XXX-XXXXXXXXXXXXX-XXXXXXXXXX-XXXX-XXX-XXXXXXXXXXXXXX-XXXXXXXX-XXXXXXXXXXX-XXXXXXXXXXXXXXXXXXXXXXXXXXXXXXXXXXXXXXXXXXXXXXXXXXXXXXXXXXXXXXXXXXXXXXXXX
