--------------------------------------------------------------------------------------------------------------------------------------------------------------------------------------------------------
--------------------------------------------------------------------------------------------------------------------------------------------------------------------------------------------------------
--------------------------------------------------------------------------------------------------------------------------------------------------------------------------------------------------------
----------Xo------?--------------X----X--o---?-----------MM?--------------o---o---X-------o---M----?---B-?-------o-----------------B-X-----------o----XX-o------M-------X--------M-----X----------X-----
-?-M-X--------M----M---------?----Moo--?B-------------X-------M-B--o------------oB-------X---------------------MX-----?------------------o--Xo----B-----------X--X--X-------------o-X--o------X---------
------o------------------B---------X---------------------oX------M---M-B----------?--------o-----BM?X----B-?---------------MMX--M-MM---o---XB--XX----------Mo----BX-X---X?----o-------o-X-X---BB------M-
--------?-X-----------o----X-------------?--M-----------X----X--------------M---------X-------M-M----XB-----B--------------------------X--B---o----X-o------o---o-X---o-----o---------o-----Mo---B-?----
-?o------?o--------X------X--o--M---------o---------oX?----------------M-B----o-?------?----o----------------M-----B--o-o--X---?----M-X----o-----XBX--o--MB--o--X--oM--?---o------------X?-----M----?oXv
-------X------oo------X-----------B---M--o--o------o---X--X----------------------M--------M------B-B------------B------o---oo--------M------?---X----M----XX---o--?--X--B------o---X-XBX---M------X---of
----------M?B-o-------------X----B------X-----MB-B--X--------------X-----------X--M---Xo------MoM-B---o------o---XM---------XX?--o-------M-----X-------------------XX--M-----o---------X----------B----f
--X------------------------M----B--X--------------X--X-----------B--------------X-------o---B-----------B---o------------X-----B---B-M??------oBX-X-----XM-----X--------------X-----B-----o----XX------f
---X--o-XX?-XX-XXX?XXXXX-X-----XX?-XXXXX-oXXXXMoX?XX---BXX-X-----X----X-X-XX---XXX--XXXXX-X-X---XX----oX--XoX-XXX---Xo-XX-?M-XX--M------X-B-------------------MXX-------M----X---X----ooo--X----X---X-Xf
----B------o-X-------------M---------------o--------------o--------------X---------o--o----------X---?----------X-o-------------------------------------------------------B----------X-----X-X-B------Xf
-o-----B----------------XX-----B---X---------o---------------------o-X-------B----X------o------------o---------------X--X----o-B--o----M-X-M---XoB--MB---XX-------X-----X-X-XM?-X-X----oXX-BB-Xo-o-o--f
m---------------X-----------B--X-X-----X-----XX-XX------X------X-------------------X---------Xo--o----B--o---o------------------------X--------B--------------X----oo--o----------o--o----o----XoX----XX
XXXXXXXXXX-XX-XXX--XX--X-XXXXXXX-XXXXX-XXXXXXXXXXXX--XXXXXXXXXXXXXXXXXXXXXXXXXXXXXXXXXXXXXXXXXXXXXXXXXXX-XXXXXXXXXXXXXXX-XX-XXXXXXXXXXXXXXXXXXXXXXXXXXXXXXXXXXXXXXXXXXXXXXXXXXXXXXXXXXXXXXXXXXXXXXXXXXXX
