--------------------------------------------------------------------------------------------------------------------------------------------------------------------------------------------------------
--------------------------------------------------------------------------------------------------------------------------------------------------------------------------------------------------------
--------------------------------------------------------------------------------------------------------------------------------------------------------------------------------------------------------
----------------------------------X------E-----------o-----X-M-X-X--------------------------X-------?----------B----?-------?-X----------B---B----------?X-----------------B--------M-------o------M--M-
-----Xo---o-o---?-------o---E------------M-----X--X------M------X-------X---XX--?--X?-----------------X----------?---X-o-----------o--------X---MX--o----BB-B-X-M---Mo--o-------X?o---X------------?X---
-M--X----X?B-X------------B-XXB-----------BM--X------------B-X---X----B---X----------?---------X---------M-M---------------X----X---------X-oB-------X-----------X----o?--B-M----------------?----------
-?--------------o--o----------------------X-B-------o------------M-----oB--X------------X----------X---MX----------------------M----?-------------------X---------------B-------X--X-X---o-----------oo-
-------------X--oM--B----------?--?----M---?oX----M---XX-------B----oX----------?B-X-?------M-Bo--M-?-----------------?----------X----M-X--X-M-XX-o---o---o--?----------o--------?--X-M-?B----o--------v
---M---M--------------?----?-----------------------X---------B------------B-------------?o------------------------------X-----------------o----------oB---X-o----------------------?-------o--X---Mo---f
----o----X----------X---------o-o---------------?---------------M-XX---X-------------------------o-------------------M------?------XM----------MM------X----------X-M-X----M---------X---B---o-X------Xf
------------X---o---BB--E----------X-------B-------Xo---------------------XB---------X------------o--------X---------o---------------------o-B-----------?o----------o---X---------X---------------o---f
-----XX-XXXXXMXX--Xo-X-X----XX-X-XXX-X---X--X-XX-----XXX-XXXX--X-X-XX-X-XX------XBX-X-X-X--X---X-XX?-X-XX--X-X--X-MX-XoXX--XX-Xo----M-----------XX--o-XB--oM-o---M-?----------------?----o-XM--M-------f
----?B-----------X--?------o------------X--X----X--o-----------------------o-----------X--BX------------X-B--o------M---------XX------X--MXBX--X--------BX------------X-X--?B---X---------B--X-X---B---f
----------------------BM----M------MX-------B-o--------------?----X----X-----------ooX---X---M--MX----X----X----------?-X-?------B--X---------X--------X----X--------X-?-----Bo---B-X--XM----X-X----X--f
mX----------X-----------------------X------XX-X-Xo----X-X-------B------X-------------------------B----X--------------------X------------X----oo------o--------B---oB-------------X--X--X-----X-XXX--X-BX
XXXXXXXXXXX-XXXX-XXXXXXXXXXXXXXXXXXXXXXXXXX-XXX-XXXXXXXX--XX-XXXXXXXXXXXXX-XXXXXXXXX-XXXXXXXXXX-XX-XXXXXXXXXXXXXXXXX-XXXX-X-XXXXXXXXXXXXXXXXXXXXXXXXXXXXXXXXXXXXXXXXXXXXXXXXXXXXXXXXXXXXXXXXXXXXXXXXXXXX
