--------------------------------------------------------------------------------------------------------------------------------------------------------------------------------------------------------
--------------------------------------------------------------------------------------------------------------------------------------------------------------------------------------------------------
--------------------------------------------------------------------------------------------------------------------------------------------------------------------------------------------------------
---------B---o----------------------------------------------------------------------X?----------MXX-----X------X--------------------------------M-------------------------------------?----------?------
-----------------------------------------------------oX---------------X----------------X?o--------??--?--------o--o-------------------o------------X------B-------E----X-----------------------o-o--o---
----X--------X-------?-------X-X--X?--------?-X------X---------?-------X---?-------?---------X-X------?---M-Bo----X-------?----X------X--X----------?----X---o----XX-M-----M-------?--X-----------------
---------------------X-------X--o---M---------------------------------------------------?-------------o---oX-----?---------------------?-o?----------------------------------------o-X------M-----------
-----X---X------o-----?----------------------------------------------?--M---X-------------------------------------XX--B----------------X?----------------------------X------M---------------?----------v
--------------------------?--------------?-------X---B--?-M-------------------------?---------------o---------XX-----------M-X-------------?--------B---------------------------M--BM----Xo------------f
--XX------------------------M--------------X-BM---------------------------o---------X---------M-------------------------------X--------------------?----------M-----------------X-?----------o---X-X---f
-o------o-----------o-------------?-?-------------------------B-------?----X---o------------o-------M---------------------------X----------o--------o------B----X-------------X-----------------M--o---f
-----------------o-----Bo--XXo--------X----X--------X-X------XX--------X-?------M--X----XM----X-----------X---------------X---X-------------------X-M-----------M--------M-----------------------------f
------------o-------------------------------------M------?--o-----------------------------------------------o-------------------oM----------M--------------M-M---------M-----X---?--------o------------f
-------?---X--B-----XM-------------------------------o--X------------------X-----X---------------------X---------?-------------------------?-----------------B-------------BB-------------?oX-XX-------f
m------------------o-----------------------------------------------------------------------------------------------------------------------------------------o------o---o---X-----------X-B---X----X---X
XX-XXXXXXXXXX-XXXXXX-XXXXXXXXXXXXX-XXX-XXXXXXXXXXXXXXXXXXXX--XXXX--XXXXXXXX-XXXXXXXXXXXXXXXXXXXXX-X-XX-XXXX-XX-XXXXXXXXX-X-XXX--XXXXXXXXXXXXXXXXXXXXXXXXXXXXXXXXXXXXXXXXXXXXXXXXXXXXXXXXXXXXXXXXXXXXXXXX
