--------------------------------------------------------------------------------------------------------------------------------------------------------------------------------------------------------
--------------------------------------------------------------------------------------------------------------------------------------------------------------------------------------------------------
--------------------------------------------------------------------------------------------------------------------------------------------------------------------------------------------------------
--o----------------M---?----MXX--X----------o--?X---X----X-----X-------------X-------------B------------X--------?------M--------X-----o----o--?-----M-?--o----M------o----------B---?X---------------X-
--------o----o-------o---------X-X----------------X---o-?--X------X---------o----------------X-?--M-o-?-o-??-------o--X----M------?--M-----------M-X----o----o--X-------X-------E------X-?--X----M-B--X-
-oM-B--------X?--M----------------X-----XBoM-X--X----------------------------o--XX---?-?-----X-----X--------------?-------------?-------ooX-B--------M--------X-Xo--------X----XMo-----------X------o---
---X--o--------X--M-?o-----o--X---------o----------------M---o-------oX--XM-----------------------?--------------------X--o--------X-------------M-X--M-----?-----BM---o------B-------MX?--?----o--?----
---X----o----X---------?---o---X-X-o-----------------M-E------?-X--M--------?--o-X---o-------M-------o-X-----o-----oo-M-oM------BM-----o---o-X-o---------------X--------X-?o-X-----?X------------o-----v
-------------X---X------X----o-----------X--B--M-------M---X----------X?----------?-------------X---X----o----M---M--------B--------o--o----------oX-----??--M--o---o-o-----E-M--------o-M--X--------M-f
-?------o--------------X-B-X--------X-------B------X----X-B---X---------?------------X--------B----X--------------------o---X-M-o-M----------XM-----X-Mo------------X-o-----X---MXo-B--o--X---EX------?f
--X-----------?-----?---M----------------BX---?-B?----------------?-----------M------------XX---o----M--?-------oX-------------X--------o---X------o---------------------o---?X--B--B---------X---o----f
-M--B-?-----X--o--M------------------------o---------B--o?-----------Xo----------?--M---?-------------M------X--------X-o--------------Bo----MM-------M--XX-X--EX--X--------------X---oM-M--o----------f
---o------------T---M------M-----E------M--------oX---XM--M-B---o------------B--------------o--M---------------o---Bo---X---B--oo-?--------------o------o--M--XX----XoB-------X-----------o---X--X--B--f
-----------MX---|-------------M--M-B--------------------M-----o-o----?--X------?----------------o-B--o---B------o---------B--XM----o--?B-------o-----------------------?--oX--------------E-----XX---XBf
m---------------X----X--X---------X---------------------------X---o----X-----X-----o-----XX----X----------B-------o--X-X----------XX--------------X----o-XX---X----X------X--------BX-----X-----X-B--oXX
XXXXXX-X-XXXXXXXXXXXXXX-XXX-XXXXX-XXX--X-XXXXXXXXXXXXXXXXXXXX-XXXXXXX-XXXXXXXXXXXXXXXXXXXXX-XXXXXX-XXXXXXXXXX-XXXXXXXX-XXXXXXXXXXXXXXXXXXXXXXXXXXXXXXXXXXXXXXXXXXXXXXXXXXXXXXXXXXXXXXXXXXXXXXXXXXXXXXXXX
