--------------------------------------------------------------------------------------------------------------------------------------------------------------------------------------------------------
--------------------------------------------------------------------------------------------------------------------------------------------------------------------------------------------------------
--------------------------------------------------------------------------------------------------------------------------------------------------------------------------------------------------------
-?oM-----------------X-o-M---X---X----MX----B--?X---------------X------------X----?-X-XB-M--------------X-------X------BM----------B---o---?---------M----ooo---X---o-----X-----M---?-o--------M--------
--------X-------B--B-------------------X-X------------o-o--E-------M-----------X-------------o----M--------?--o-X----------M---------B-o---------M-X----B---------?--XMX---X-------------o---------B--X-
----X-----X---?-----------X-------X----------X--X------X---X---X-----M-------o--X---------o--------B--------------?----------X-M-------------------------M----X-----------------o---B------?B-------o---
---X--------o---o-o-?------?----------------M-------------------X--?-------------------------X----?-----------MoX----------oo-----XX----?--o----------------B?----BX---X---------------X-----B-----X----
--------o-------------------------X--M-----------------------M--------BX---------M-----M-----X---------X----------M-B---MB------------------oX-o------o--XX-------------XM-o---------?----B-----Xo-----v
-MM---X---o---XX-----M----X-----o--------o--?--------X-----X----o-----X---?-X------?-----Mo-----X--o-----o-o-o-?-------------M--X-X-M-------------o-----X------M-------------------------M---?---X---X-f
-------M-M------?X----?X-B--B--------X----------oM--------?---X---------?------?-------------------X---------------------o----?-oX-----X-X---?M---X---Mo----B----M----------------oX---o--X---XX-------f
--X----------------M?-----X-------B----X------?---oM-M-----------------------------------M--X---o----M-------X-o-X----------o--B--------o-------?M-oM--------------o-?----M--?M------oo--------oX------f
-?---o---------------------------B-?-------oB--M------M-----M-----?X--o-M--------?---o------B--?-------?----MX--------X------MM--X------------M---------X---X-----?--------o-----XX----o-M--M-----X----f
---M------------X-?--------M---------X------B?----M----?X-------?-----------X------X-----------------o---------o---------------B--?-----o-o-------------------X-?-------------------------o---X-E-----Xf
--------X---M---o-----------------B--B--------------------MX-------X----XMM--X-X--B---o--?---o-?----------X----o-------------XM----X-?X---X----o-------------------B-M--X-B--X--o-----------M---XB--X-Bf
m---X----o---X-------X--X--Bo------o----X--------------o---------------X-----------o------X---------------B------------X----------XB---X-----o--X-X------XX-XBX-X-XB------X--o------X--------X--XXX---XX
XXXXXXXXXXXXXX-XXXXXXXXXX-XXXXXX-XXXXXX-X-X-XXXXXX-XX-XXX-XXXXXXXXXXX--XXXXX-XXXXXXXXXXXXXXX-XXXXX-XX-XXXXXXXXXXXXXX-X-XXXXXXXXXXXXXXXXXXXXXXXXXXXXXXXXXXXXXXXXXXXXXXXXXXXXXXXXXXXXXXXXXXXXXXXXXXXXXXXXX
