--------------------------------------------------------------------------------------------------------------------------------------------------------------------------------------------------------
--------------------------------------------------------------------------------------------------------------------------------------------------------------------------------------------------------
--------------------------------------------------------------------------------------------------------------------------------------------------------------------------------------------------------
-----------M-M---------o----------B-------B--------MB--M---------XB-------E---o-----X-----o----M-------X------------------------X---------o--X-o--E--M--M------X----B-------o--o-------X-----?--X-----X-
--------MB------------X------X?-oM---X---------o-------------X---o------ooX----------X-----------?--o--XX--o---X-----Xo--------B------BM---M------XX-------------B-----------B----------X-----X---------
------------X----------B------------B---B----------B---o-------?----?----B-o-X----X------X-X------X------------X-B-X------------------------M---?---o-o-Xo----o---oX---oX----o---X-X---M----------X-o---
---?------o-----------X-X--M-X--------------o-------M----o--?----X------------o-X--o----------------X---------------X-----X-X---X-----MB------X------XX------------B------------M-------------B---------
------X------B--X--X-o----------X-X-X-o--------X-----?--o----?--------X------?----X-o--M-----oX-------M-M----X--X---------------X--------Xo--M-M-----------Xo--------M-X----XM-----M------o-X?-------X-v
----B-B-o-M------------X--B-------------------B-BB-----o-------B-o?--X----o---?--X----------------?-----------------o--o---------------X----E---o-o-----------E-o-X--------X----M----X---------M-----XXf
-----X--------X-----X---o----------?-?----------X---M?B-o-?M-X--?--------X----------X--X----X---X-----X?----?------M-----?--oMo--M----B-----Xo---X-----------XB------o-----------------BX---XX---------f
-------M---------------o-B----o------------------------X---------B-M----X---M--------------M-------B-B---o-----o----------B----o--------X---------X----------------------------B---o-X-----XB-?o-?X---of
--X-----o---XX--------Bo--B---------X------------ooX-------X---o--------o-----M---------------o---X-----X--?-?M----------X-----X----o-----------Bo---M---------M---o----X?---M-----X----?--B------o--?-f
-------?X---X-o-?---o-------------------o-----X---------------------X-o-----X--o-?---------o----------------------------o------------BX---X--------o--------XT------B------------o------------XX------Xf
-------------------------X-------X---o--------X--M------X-------Eo-------X--XX-----X-o-----------o-o--o-B------X-X---X-X----o----XX-o-X?--X--X?M--XB--oX----X|--o----X-------X--------XX---X--X-----MX-f
mX---oBX-------X-------B--------X-o--X-----X--X-----------------X--o------------B-X---------oo-o---X--X--------X----XXo-----B------oX------oo---------------XX--XX-Xo-X-o-X-Bo-------XXB-----Bo------BBX
XXXX-XXXXXXX-XXXXXXXXXXXXXX--XXXXXXXXXXXXX-X-X-XXXXXXXXXXXXXXXX-XXXXXXXX-XXXXXXXX-XXXXX-X-XXXXXXXXXXXXXXXXXXXXXXXXX-XXXXXXXXXXXXXXXXXXXXXXXXXXXXXXXXXXXXXXXXXXXXXXXXXXXXXXXXXXXXXXXXXXXXXXXXXXXXXXXXXXXX
