--------------------------------------------------------------------------------------------------------------------------------------------------------------------------------------------------------
--------------------------------------------------------------------------------------------------------------------------------------------------------------------------------------------------------
--------------------------------------------------------------------------------------------------------------------------------------------------------------------------------------------------------
---BX------o------??-------X-------------B----------?oX-o-M-------oX------X-------Xo-----------X---o--M----oM?----?-XX-o-----X-X---o?X-M-oMo--o-------MX--------o------X-X--M-X-----X---X--o----?-------
-----o--------------X--o-XX-X---?-B?----X--------o----------------oX---o----?--X---------B------?---------------------X-X----X--o-------X----X------?---------X-----X-------------o?-?-X--X-------------
---?-----?-BX---X-B-----------X-----M---X-----oo---?-X-------o---o--------o-----X---------------------------B--M--o--o---------BX------oX---B---?-o--X---------o-------X---B----X----------X---M-----M--
---------------------o-X-M-o---M----------X---o-----------?M------------M---------M-----XB---B------------X---------------oX------?--o-B-----?-------X---------o---------------------M---oX------B------
-----MX---------o----------------o----------o------?-?---------o--?--oo--B-o-X-----------o----oX-----------------B------??-----?M-------o--------?-----X-o--oX------oB----X----?B---------------X------v
---------------o-----M------------------o---------------?-----------o----B--------X-?-M----o----------------M--------X?----------X-------M---BX------X-B-----------------X------------------o---X------f
-----M---X------------------------?------X----M-M---o--------o--X---X-----------o---------------------o---?--o---M---------?---X----------------X----E---?----M-----X-------------oX---o--X?-XM--o-----f
------------o-----------XX-X---------------X------X--------B-----X-X----------XX-------o-B------X----------------------------------o------B--M----o--M-X--B-B---?----o----M?-------------------?-------f
---X--XX-XX-XXXMX--X----XXX-XXXX--o?-XXX-X-X-XXXXB-B-X--o---X-XXX------XX-XXX-----X--XXXo-X--X-XXXXX---XX--XXX-XX--XXo-M-XXoX-XX-X-------------o------?----X-----------oM---B------BE------X----X------f
-----Xo------o---------------B------------X-----X---o-Xo----o--------o---------o------------Xo?----------B--X------X----------------------T-----------------X-----X--?-----?----X---B-MX-----X---------f
---------M---------B-?B-M-----------------X-B---------X-o--------------o-X--?------M----o---------XX-------------?-------------o----------|----X-----B----X-------------------B-o-Xo---X-X-M--XX-----?-f
mX-X-X----------o-----X--X--------B-XXoX----XB--------B-X---o-o-X-X-------------------------------------------------X---------X---o-------X---B----------o---ooo-o-X---o---------o-X--B------oX---X----X
XXXXXXXXXXX-XXXXXXXXXXX-XXXXXXXXXXXXXXX--XXXXXXXXXXXXXXXXXXXXXX-X-XXXXXXXXXXXXXXXXXXXX--XXX--X-XX---XXXXXXXXXXXXXXXXXXXXXXXXXXXXXXXXXXXXXXXXXXXXXXXXXXXXXXXXXXXXXXXXXXXXXXXXXXXXXXXXXXXXXXXXXXXXXXXXXXXX
