--------------------------------------------------------------------------------------------------------------------------------------------------------------------------------------------------------
--------------------------------------------------------------------------------------------------------------------------------------------------------------------------------------------------------
--------------------------------------------------------------------------------------------------------------------------------------------------------------------------------------------------------
--B-------------M-------------o---M--M----M----------------M--X--o-X---XX?------M---o-M--XB?X---------?------M?-----------X-X--B--------X-M----oXo---------?-X----------o-X-o-----------?B----B-----X---
--oM--?-----?-------B-?---?-M---B------M?------------X---------o------X----?--------o--------------M------Xo---o------Xo----o----------?-----X--o--X-------------X-----X------X----B-----X-o---------X--
-?-----X---------X-X---------o----MM-----XM--X-B-B-X--o--B--X-----o---o-----B------------?--X--X----X--BX---B-----------------X----?-X---oX-BX-X--------XMX-----oX?B----o-------M----X--M-------M---X---
----X--X?o----BX----------------o----X-?---X-------------------------o--X----X---oX-B--X---MX-B-X-------o-------XX--oo--B---X--------E----------M-----X------------X-----------------B------------?---M-
-----o-------M---------o--Xo------B--B-------XX--------------X--B----o-X----X-ooo--o-------------X----------X--------X-------------X-B--B-oBM-----o-----M--B?--o--o------------B-------o--B--o-----BB--v
--M---BXB-X----Xo--?---------------?----XM-----X-o-----------X--Xo?-----E------o--------o--oX-------o--B-o---------oX----X-----XX-------o-----o--------------M-X---X---M---------B----X---B--------B-X-f
--------------------B------?---B----X-oo------M-----Xo---B----------X-o-M---X----o---o-M--------X---XX-------?--X--X---?---------o----X--------oX--oXo?X--B---------X------M--MM-----X------E----------f
----o------X--------o-B-M---------------Bo-------------------X--o-----X-----------------------B---M--------------X---X-----M--BX------------o---o-------M----------?---Bo---------------Mo-XXX-----X-o-f
-M--o---X---Xo-X-MB------------M-------X-----o----------?----X---?-------oooMX--X-----Xo----B---?----M--X------B--X------------X----------o--X-----------X--X--o----?----MM---?o----MX------B-X-------of
-----?---o-M-------B---X--X-----X---X-----X-------X---------B-------ooo------ooX--X-X------------------------XX-----Mo--B---?---B----o---------Xo---X-----X--X-X-----X----------B----o--------BT-B----Xf
--M---------------MX---X-?----B-B----------X-o------B-M-----------X------------X----X-----------X-MX--o--XXM-o-------o--B---------X?oXX-M----B---B----BX----------------BXX--XBB-X-o--o---B--X-|-------f
m--X---o-o-X--------o--------------o-------X--X----o------B----B---X----------X-----------------X--------------XX-B--X--X---Bo--------------X--X---------Xo-o------X---X------oXXX------X-X--X-Xo-----BX
X-XXXXXXXXX-X-X-X-XXXXXXXXXXXXXXXXXXXXXXXXXXXXXXXXXX-X-XXXXXXXXXXXXXXXXXXX-XXXX-XXXXXXXXXXXXXXXXXXX--XXX-XXXXXXX-XXXXXXXX-XXXX-XXXXXXXXXXXXXXXXXXXXXXXXXXXXXXXXXXXXXXXXXXXXXXXXXXXXXXXXXXXXXXXXXXXXXXXXX
