--------------------------------------------------------------------------------------------------------------------------------------------------------------------------------------------------------
--------------------------------------------------------------------------------------------------------------------------------------------------------------------------------------------------------
--------------------------------------------------------------------------------------------------------------------------------------------------------------------------------------------------------
---------B---o---------------------------------X------------------------M------------------------------BM-----------------X-?---------------------------------X---------------------------------o?------
---X-----M-------------X-------------------------M---oX--------------------------?-X----?o---------?--?--------o--o--B------------XM--o------------X------B-------------------?----------------o---B----
-------------X-----X-?-------X----X?--------?-----------------?----------?-?-----------------?--------------Bo-------------o--------------?--------------XM--o-----X-M--B?------------X-------o---------
-------??------M-------------X------M---------------------------------------------------?------------------------?------------------M--?-o-----------------?-----------------------o-X------M-----------
----------------------?------------------M---M-----X-----------------X------------oM----------M-----------------------B-----------------------?----------------------X------------B--------------------v
--?--------------------------------------?--------------?------------------X--------?---------------o---------XX-----M-------X----------------------B------------X-----------------B-M-?--o------------f
-----------M------X---------M----o---------X--------------?----------------B--------X---------M---------------X-----------------------------------o?---------------M-----------------------------X-X---f
-o--B---o-----------------------------------------------------B--------------o-o-------------------M---o--------------?---------X----------o--------o------M---oM------------BX----o------------M--o---f
---------------X-o-----BX---X---------?---------------XX----XX-------X-X--------M------BXM----------------X------------X----X-X-----------M------------------------------M---------------------------?-f
------------oo------------------------------------M---------------------------T--B------------M---X---------o--------------------M------o---M--------------M-M-------?-M----------B--------------------f
--X----?------X-----XM----------?----------B----------M-X-------------------------------------M-------o-------------------B---------B------o---------X--------o-M-?--------BB-------------?o---X-------f
m-----------------------------------------------B------------------------------------------------------------------------------B----------------------------oo----------o---------------X-B---X----X---X
XXXXXXXXXXXXX-XXXXXXXXXXXXXXXX-XX-XXXXXXXXXX-XXX-XXXXXXXXXX-XXXXX--XXXX-XXXXXXXXXXXXXXXXXXXXXXXX-XXXXXX-XXXXXX-XXXXXXXXX-X-XXX--XXXXXXXXXXXXXXXXXXXXXXXXXXXXXXXXXXXXXXXXXXXXXXXXXXXXXXXXXXXXXXXXXXXXXXXX
