--------------------------------------------------------------------------------------------------------------------------------------------------------------------------------------------------------
--------------------------------------------------------------------------------------------------------------------------------------------------------------------------------------------------------
--------------------------------------------------------------------------------------------------------------------------------------------------------------------------------------------------------
---X-X-B---------------------?--X------?M-o-----------M--M-----?------------o--------o-----------------XB---o----M-----o--o---X-?--------------?o-X-X--M-----X---X---o--?B--?X--?-------B-------------o-
----X---------?-------X-------o-X--X-----B--------B-------------------M---?---?--------M--?-X-----B--------?-?-----X----X-o----------Xo---------XoX-------B-M-o----------X---------MoM-------X----------
-M---o---o---------------BX--?------------X----o-----?---XBM---------------------X--X------------B----BM-?-----X-o--------------X-B----------B--------o-M-X--B-----?----X-X-o---X------X-Bo---X--o-X----
----?-----------X?X--------------M---------X----------X--------B-o--------oX----M-----?-------o---MM-B-------------------X-------------B---M-------------o-----Xo------M-MXM-X------X---M-X------X-o-Xo-
------------XB------B--M-------o--?----?---X------X--B-----?-E-------X-------X-------------X---------------?-o------o-M--------M----M---------------o-o------XE--o-X---------X----X--o-----o----------Xv
-X---XX------X------X-------oM------------------XX-----------X------------------M---------?-X--?---B---B--------oo-?------------o---------------------o--o----M-X---X----------?---M-X---------X---o---f
---------------------------B-----o-?-------o---------Mo-------oX--X---?X?---o--------B-X----------Xo------------------X----M-X------XX--o--?---BB--------------XoMX--B-o-MM--M--------?-----o----B----Mf
-o---o--------------X----o---XX-M-------o-----o----------X-B---X-X-------X-X---X-----------E------------o-----------B-------------------o---o---X-------X------------------------------------------X---f
-XXX----?--X-----XXX-X-X---XMX-----o--X----XXXXXXXXXXX-XX--X-X--X-oo-XX-X--X-------X--X--XXXMXX-XX---?X-XX-X-?M-o----X-----XXo--BB-----X----------X-----------------X-------M-o---------M-?---X-----o--f
---------X---B---------X-------E-----M---T----------------M------X-B----------o-B------oo------o-------------------------X-----MX---o-----------M----Xo--T-M--------X--B--?---Xo-----------------T--X-of
---?-X--B----------------------B-X-------|---------?-X-----B---M--X----o?-----------?-X-----X-----X-------X-o----------o?----o-----o-XB----X-------M?-X--|--o----o-o---X---o-X----Bo?-B-?M---XX--|-----f
mX---X-------X----------X-X--------------XX---------X---------------X----X-B--X-X----------X---X----o----X-XXXXX--o--X-------X--------------o----------X-X-----X-------o-------X-X----B---X--X--XX----XX
XXX-XXXXX-XX-XXXXXXX-X-XXXXXXXXXXXXXXXXXXXXXXXXXXXXXX-XX--XXXXXXX-XXXXXXXXXXXXXXXXXX-XXXXX-XXXXXXX-XX-X-XX-XXXXXXXXXXX-XXXXXX-XXXXXXXXXXXXXXXXXXXXXXXXXXXXXXXXXXXXXXXXXXXXXXXXXXXXXXXXXXXXXXXXXXXXXXXXXX
