--------------------------------------------------------------------------------------------------------------------------------------------------------------------------------------------------------
--------------------------------------------------------------------------------------------------------------------------------------------------------------------------------------------------------
--------------------------------------------------------------------------------------------------------------------------------------------------------------------------------------------------------
---M-------------M----X---?o-X-------o--?-------------X----X---?M---------oM--------M------M-----o--?----X--------------XM--------------X-X-oX-XM---M-X??B--o--X--X--o-----X------o---------o---------o-
---------------------X------------X-?-------B-----X--o--o---------o---?-X--------------------------------X--B----?--------------M--X-o----X----------B-------------------X------o----------o------------
-M--X----X-X--?--X-M--X-X--oX-----------------X-o-o------?-----?---B---------BM-----X-o------X----------X-X----X--B----------M----B-o------B---------X----X--B---BooX----X---------XXX---oo---X--o---X--
----------------o------------o?-----------------------X--------------o-----X---------M--X-----X-----M----------o?------MB--------M----M----B-------X----?-----X-X------MB---B-X-----X-X-----------------
--XBX--?---------M-?B-------------?X-X--o-X-B---------Xo-------------X------Mo-----X-------X-----M?--------M---------B------X--o----------------B---------Bo--------oo---------?M----?---X-------o-----v
-----X-------?---------------B-----X-X--------oX-M------------XX----------------------o------------------o----oX--------X---------M--o-?-----------?-oX-----o--o-----o---o-XX-----------------o-X------f
--------X------o-----M---?-o--oX--X---?-----X?-o--X------B--------B--M--MX---o?-o------------------?----------------B---------X----X------------M------------------B-------oo--XX-----MX-?---o----B-X--f
---B------------X-----X--------------------B-------------------?------B--------X-----------------------------------------------X----B--o------------o-----o----------M----------------------o--------X-f
--X-------XXXXX-BX-X-X-oXX?-XXo-XX-oB--MXX-o--X----XXX--?-X-XX--XBXXXX--XX--XMXX--XMX--X---X-XXX?-X----X-X-X-X-XMM-X------X-XX-----------o-------------X?---X----------M--?-----o--------X--X-X?----o-?f
---o?o------------M----------------Xo----------------B------X--o-----------X----?---X--o-X------------------------B-----o--X---?-----------B----X-B------XX--o---------------M---------------------?---f
-----o--------X-M--------X---------------X----------o------------------------------o-BX----o-------------?--------------o--------B--?-----X----X---BX--------XX---M--o----------------BX---X-B-X----o--f
m-X----X---------------X-----X--o-------X--------o--X-----------Xo-------X-----X------B------------------------o-----X-----Xo--------o-----X---B-------o--B--X-----B------o-------o---B----o-X-XXXo--o-X
XXXXXXXXXXXXXXXXXXXXXXXXXXXXXXXXX-XXXXXXXXXXXXXXXXXXXXXXXXXXXXXXXXXXX-XXXX-XXXX--X--XXXXXXXX-X-X-XXXXXXX-XXXXX-XX-XXXXXXXXX-XXXXXXXXXXXXXXXXXXXXXXXXXXXXXXXXXXXXXXXXXXXXXXXXXXXXXXXXXXXXXXXXXXXXXXXXXXXX
