--------------------------------------------------------------------------------------------------------------------------------------------------------------------------------------------------------
--------------------------------------------------------------------------------------------------------------------------------------------------------------------------------------------------------
--------------------------------------------------------------------------------------------------------------------------------------------------------------------------------------------------------
--X---oX--o-------MX-X---X-----X-XM--oBM---------o---B--X----------X---X--------M--Xo-----------X----M---------------X-o-----?--BM-------EX-oXX-----o-----B-----B?--------X-----------X------oo---B-B---
-------------MX-----oXo-------X-B------------------X-X---X---o----------------B----X--X---?-------o------------?------o-------oo----B--MBM-?o-----o---------------o--------------------------o---B------
-M---MB-----------o-----XX--------Xo?X--BB----X---X------------Xo----X--------------M---X----------oX----X-X-?-----B-----X---B--X-X--?-------?------Xo----M---------X--------X-XBX------o---------------
--X-----------X-----------X--o--X--------------B---------o--X---------------XB---X-----o-o----oo------M-X-----?X--------o---X----M------o--X--------B---X---------X----B-XXoo--XB----X----X--X-B-B---?--
---------XB---X-X--o--------X--X-X--M--?-----------M-X--X----X-o-----XX------X----------X-o?-o--X---X---o?----------X-o?--------------------X----?-M-----------o------B-----------?---X-?---------B----v
-----------M-----X---XM--------------X-----B--------------------M-BX-------MX--MMo--o---------X-----------------?--MX--------X--XX------X------o----o----oB--X-X-?--------X---?X-----------BoB--------Xf
---------X--X-o-o--o?----X-----X--XM-----o--o----o--------o--X-----XXM--oo---------X--------M----?o--X--X--X-----o--------o----M-----B----------------Xo---oXX----?-o---B--o--------E-o---M---------?--f
-X-X----M-X?--------------------X-----M-------X---XX---------B-?-?----?----------?----M---?--oX----XX--------------o------o--------X---o--o-------M--?--o-----------------------BX-MM-------X?--oX-----f
------------------oXB---o-?---o---oX---------M-------MXXoM--X--------------oX-----------X-------------E---Xo----------o-----X----oo-X-?---o?-------------------X-o-------X----------------M----------X-f
-X---XM-----X-------X---X---------------oX--------M---o-----B------o-B----------X--X-X-----------?----XB-M--B-M--X--o------------X-------X--o----?--------------------o-X------X-X-----X----?-o---XX---f
-XXMM-----X---o----o-X--------o--------M-X-M-------??--o-o------X-------o?------oo--MX---X-X-o-o----XX--------E-------------------Xo-XX--X-X-------------o--MX-----?----B--o-X-------X-X-o---B--X--XX--f
m-----X------------------XXX---X-----X----------Xo-------X-B---------X---------X-----X--o----------o--------X-X----XB-XX----------X--X--------X---oX----X-----X-X-----X-X----X--------B-oX---X----XX--XX
XXXXXXXXXXXXXX-XXXXXXXXXXXXXXXXXX-XXXXXX-XX--XX-XXXXXXXXXXXXXXXXXXXXXXXXXXXXXXXXXXXXX-XXXXX-X-XXX-XX-XXXX-XX-XXXXXXXXXXXXXXXXXXXXXXXXXXXXXXXXXXXXXXXXXXXXXXXXXXXXXXXXXXXXXXXXXXXXXXXXXXXXXXXXXXXXXXXXXXX
