--------------------------------------------------------------------------------------------------------------------------------------------------------------------------------------------------------
--------------------------------------------------------------------------------------------------------------------------------------------------------------------------------------------------------
--------------------------------------------------------------------------------------------------------------------------------------------------------------------------------------------------------
--------------------------------------------------------------------------------------------------------------------------------------------------------------------------------------------------------
--------------------------------------------------------------------------------------------------------------------------------------------------------------------------------------------------------
--------------------------------------------------------------------------------------------------------------------------------------------------------------------------------------------------------
--------------------------------------------------------------------------------------------------------------------------------------------------------------------------------------------------------
-------------------------------------------------------------------------------------------------------------------------------------------------------------------------------------------------------f
---------------------------------------X------------------X--------------------------------X--X---------------------X-------------------X--------------------------------X-----------------------------f
----------X------X--------X----XX-------------------XXX------------------------------------X------------------------X--XX-------X----X--------------------X-XX-X------------X------------------------XXf
-------X------X--------X-----X-------X----X---X----------XX---X------------------X--------------------------------------X-----X-X----X-----X-X------------------------XX--------------------------X----f
------XX-X----------X-------X-X--X-XX---X-----X------X--X-----X--X----X--------------X--------X----X------XX---------------------------------X--X---------XX-----X----X-XXX-X------XX-------XX---------f
m--X--X--------X--------X----X----X-X----X----X-------X---X--X--X------X-----X------X-X----XX--X-XX--X----X----XX---X--------XX-------X----X-X----X----X-----X-X-X-----X-X----X----------X-----------X-X
X-X--XX-X--XX---X-X-X-----XX---X--XX---X--X---X-X-XX--------XX---XX----X---X--X-----X-X-X-XXX--X--------XX-X--XX--X---X--XXX-----XX-------X--X---X--X----X--------XX---X---------X---X-------X---X-X-XXX
--------X-----------------X--------X-------------------------------------X------------------------------X------X---------------------------XX-----------X-----X----------------X-----------------------v
-------------------------------------------------------------------------------------------------------------------------------------------------------------------------------------------------------f
