--------------------------------------------------------------------------------------------------------------------------------------------------------------------------------------------------------
--------------------------------------------------------------------------------------------------------------------------------------------------------------------------------------------------------
--------------------------------------------------------------------------------------------------------------------------------------------------------------------------------------------------------
---------B---?---------------------------------X------------------------M------------?--------------M---M-------------------?--------------X--------------------------------?-----o---------------------
---X--------------------------------------------------------?---------------------------?o---X-----?--?--------o--o-MB------------XM--o-X----------X--M---B-------------------?----?-----------o-o-B----
-------------------o-?-------?-X--X?--------?--------X-X--?---?----------?-?-------?-------?-?-X----------M-B-----X---?--X-o--------X-X---?--------------X---o-----X-M------------X---X-------o---------
-------?---M---M-----X--------------M---------------X-----------------------o-----------?------------------------------X---M-----------?--?---X-----------------X------------------o-X------M-----------
-----------------o-----------------------M---M-----------------------X------------------------------------------------B-o----------o----o----------------------------X---------------------------------v
--?------o----------------?-----X--------?-------X------?-------------------------------------------o---------XX--M--M--X------------------?--------B------------X--M-----------M--B---?--o--?---------f
--X--------M----------------M----o------B-----M--------?--?-----------------------------?-----M------?B------XX---------------------------?-------o?----------------------------X----------------X-XM--f
-o--B----------------------------------------------------------------------X---o-------------------MM--o-o----------------------X----------o--------o-----------M------------BX-----o-----------M--o---f
-----------------o-X---B---X--XX---X--X------o--------XX-----XX-X---------------M-------X-----------------X------------Xo-----------------M-------X-M-------------M----------------B--------?--------?-f
------?------M--------------------------X---------M------?---------------------------o------?-----X-------M-o---------------------------o------------------M-M-------?-M---------?---------------------f
--X-----------X-----XM----------------------------------X------------------------X----------------------------------------B----------------o-------B-X-------BM-M-----------B-------------?o--XX---|--?f
m----------------------------------------------------------o-----------------------------------------------------------------X-B---B----------------------B-oo------o-X-o---X-----------------X----X---X
XX-XXXXXX-XXX-XXXX-XXX-XX-XXXXXX-X-XXX-XXXXX-XXX-XXXXXXXXX-X-XXXXX-XXXX-XXXXXXXXXXXXXXXXXXXXXXXXXXX-XXX-XXXXXX-XXXXXXXXXXX-XXX--XXXXXXXXXXXXXXXXXXXXXXXXXXXXXXXXXXXXXXXXXXXXXXXXXXXXXXXXXXXXXXXXXXXXXXXX
