--------------------------------------------------------------------------------------------------------------------------------------------------------------------------------------------------------
--------------------------------------------------------------------------------------------------------------------------------------------------------------------------------------------------------
--------------------------------------------------------------------------------------------------------------------------------------------------------------------------------------------------------
-o--X----X---Xo---MB------B-o-------------o-oX------------?---?----M------o--X------X--M------------o------o-------?-------X----?X------o-------------X----B--------------B-----o--------------X-X------
-------------o-X-----XXB------X-----??-------------B---?-------------B-X-?------BX---X-----------XMo-----------------X---o-o---------------o-B----XM-----XB-----------X----X----X-?--------o-X----X-o---
--?------X-XM-------B------M---o--M-------M-------M-Xo-----------M---------------------M------------o--X-------X--B-----------o-X------oB---X---B--------------B-B-o-----o----BX---o--X--B-oM-o-?oX-----
-----X----------oB--X--------------o--E------XM------X---X---o---------?--M-------?--X-------M--X-------o------------------o-----MB----X-------B--X-----------X--------oB-o-X----------------o-------Xo-
-------B--B-X--------X--------B--M----?-o--------X--------M---------M---------M----------------------B---o-------M-------X--Xo----------X---B-X-o---?-----------M--------o----o-X-----X-XX-------------v
-----X--M?--oM--------?-----------------o------XX----B-----------------o-X------B--XB---o------------X-M------------------------B-o-------o----------o---?-BoB------------o-X-X-----M---X---X?-----B---f
-X---------?-----------?---------?---------------------X-?-----X----B-----------------------M----o---------o-X--------------------------X-----E-M-----o----------X---X---------------------------Mo---Mf
-------------X----X-X--------o--------------------------------------o----------------Bo-o---------B------X---------X---------o-----X--X------BX-------------------------X------XX----X---------o-------f
--XX--XoXXX-X-XXX---X---X------XX-X-o-XX-?X-XXXX--o-X-o-XX--XXX-X-XX--XX-XX-XX--X-XXX-----X-X-?B?--?----X-XMX-oXX--Xo--XXMXMMXo-------------o----X-?-XM----M-?-o-?------X---------------Xo--M-X---MMoo-f
----------------E----X---o--?-------o--o-----------M-----------------X-----B-------B--o--------------X------------?--o---------XM----BM-----------------X-----X-------B--Moo------TX-X-o-----X-X----o--f
-X---B---M-M----M-------B----X---o------X----------------------X-----X-X-MX--X--------X-?-----------X-------oX-----M--M----------------?-X----X--------Mo--?-----o----------X-----|-X---M?-----X---X---f
m-B-o---------------o--------o-------X-----X--X-------------X---------X----o---------o-----XB-X-------o--------X-----------X---XB-o--o----------oo---X------X------B----B--X-X-o-XXB------o--X-X-----o-X
XXX-XXXXX-XXXXXXXXXXXXXXXXXXXXXXX-XX-XXXXXXXXXXXXXXXXXXXXXXXX-XXX-XX-XXXXXXXXXXXXXXXXXXXXXX-XXXXXXXXXXXXX-X-XXXXXXXXXXXXXXXXXXXXXXXXXXXXXXXXXXXXXXXXXXXXXXXXXXXXXXXXXXXXXXXXXXXXXXXXXXXXXXXXXXXXXXXXXXXX
