--------------------------------------------------------------------------------------------------------------------------------------------------------------------------------------------------------
--------------------------------------------------------------------------------------------------------------------------------------------------------------------------------------------------------
--------------------------------------------------------------------------------------------------------------------------------------------------------------------------------------------------------
----------?----------B----BMo----ooX---X-M--------------?--o-o--ooo--o--Xo-X------X----?X------X-------X--------------X-X---X--------M-----------X---------X----o-----o-----X----o-------X----?-M--M----
-----X--------MX-X-----------oo-?-o-------X--o-o----XB--------X------X------o-o-----Xo--Boo------M--oXM-----?-XoX-o--------------o-X----X---------o---BM------o-X----M---X-X------o------------------XB-
--XM-------X--------------M---------oX---X----X-----------M--oX-------o-------XX-X---------o-X------------------------XX--X------------M-----?-o----------MM-------X--X-----M----MB-----------?-BX--o---
--------XM-o--?Xo---X--------o?---B-----BX---------X---------o-------o------M---X-o-------------------o-?o---M-B-------o------XB--X-X---------XX------?------BMo---------o---?--------M-----------------
----------X-o--E-Xo---------------o--------o----X-o----M?---------?o---M-X-------------o---M-B-?M--X-------X----M---?----X---------oo-X----------o-------?MM-------o-X--XX--------X----X--Xo--------Bo-v
-X------X-----XX---M----X-o----------XX----X------------------------------X-BX---?---oX----------------XX---------X----??-X-----X----B---oB----------o-------o-B----o-BoB-B---------------------?-----Mf
-------------------------------o------X--oB----------o--M-----o--o------M--X-----------o----MM--M?X---?-B-X--------------X-------X------X---M-----o-B--M-B-X------?B--------M-------B---B--?X-?--------f
--------------------B---M----X-o-M-------B---o-----o-----M---X----oM------------X-XM-----------------------X---X--o---M---o---M---------------B-?--------XM----oX----X--------o-M-M-------------o-----of
--o-----o-------------X------o-----M----o--?--B--o-------------------o------XE--X?-----X--------------o---?-----X---?------------o-B-------o---------X--?---o-----oXX----B--o--------------o------X----f
------------------------o-----oo------?o---------B-------------o---?-------X-?X--------B----------?-X--TX---X--------------X------------X-----X-?--XB-X----------M--X---M---X-XX---X----X-B---X-oo--T-of
---X-------XX---oX---o-X--------X-----------------o-----B-----?-----B------B---o------------M-oX-----XB|--X---XM-o-X----MX---MX---M--?-X--B---X--?--o-Xo--B-o------------o-?--X-------X---X--o-o--?-|X-f
m------X-------X---------X---X----Xo------------o---o-----o------X-------Xo-o--------B---o----X--------Xo-o------------------------------X---o------X--X------o-----------------B-------X------X----X--X
XX-XXXX-XXX-XX-XXXXXXXXXXXXX--X-XXXX-XXXXXXXXXXXXXXXXXXXXXX-XXXXXXXXXXXXX-XXXXXXX-XXXXXXXXXXXXXXXXXXXXXXXXXX-XXXXXX-XXXXXXXXXXXXXXXXXXXXXXXXXXXXXXXXXXXXXXXXXXXXXXXXXXXXXXXXXXXXXXXXXXXXXXXXXXXXXXXXXXXX
