--------------------------------------------------------------------------------------------------------------------------------------------------------------------------------------------------------
--------------------------------------------------------------------------------------------------------------------------------------------------------------------------------------------------------
--------------------------------------------------------------------------------------------------------------------------------------------------------------------------------------------------------
-B-X------------XB--------------------------------?-------------------X-------------o-----oB---M-o-----XX------ooo-X--------------X------------X-o-X?-MX---------X---X-X-----MB------XoX----------------
-----------------------B-----o----o-----X---?-M---------B-XoX--?-M-----o-------X------o------X------X------o----X----M-o-?-MXo------X--o-XB----o--B-------X--X-------X-X-Mo------------o--o---X------XX-
---------BX-o---o-B------B--o-??-X--?----X------X---o----o-----------------X---B--o-?-------o----X----?o--o-o----X-------------------?---o---o-----------o------M--o--------XX----o--Bo-M-----X-----X---
--X-------X?-----X--------oX-----X------X----oX--Xo-----X----?---X?-XX--M---X---o-X-----------MX---M----------------X--XMM--------------------------B-------X-----o---?----o--X-------o-----XM--XB------
-MoMo-o-------o-M---M--?X-----M-------X--X----BX-----X----?-----------o------------------o-X-----------M-----M--------o---?o?----------M---?----------------X-------X---------------B----o-o---B---XX--v
------------------o-------M-----X-B---------X--------------------X-XXMX---------------BM-XX-?--X--------------------oX-----------XoB---------?o-------M?XXoX----B-M----------------------X?-------XX-?-f
-?--X-----?--X--o--B---------------M--X------------o------X-X-----o-----M---o-------B---M--------X----ooM-------------?M-----X-o-o------?-o----X----------------X-----o------o---o-----o-----X---------f
--X-----------------X--------------E---o--------------X----o----o-o-o---------o----------------o---X------------X-oB--------------o----------o----X----------------XX-------o-M------X-X--?------o----of
---XXXo?--X-XXXX-X---XXX??X-XXXX-?-Xo--XXXX----X--X-B--X----oXXX----XX-X-X------XXX-X--X---oX-----M---X--XXXXoXXX--X?XX------X-----B----X-M?--X--X----o--X---o-------X-X---X---o-X----B----X------o----f
--Xo------------o--------------X-----o-----oM--oX--X--------X----B-?--------------X------------------M--X----Bo------X-----------------oX------X--------M--X---X--X--XX-M---------MB--X--BX----B-XB----f
---------o-------Mo-o--o----------o---o?------X--------X-B-----X------BXX--MX-oo----------X-------------X---------------M-B-?-M-B-X----B-----o---?---?---X-Bo---o-X------------oo--------X----X-?o----Bf
m--X-------X---X--o-X-------B--X--------------X---------Xo--------------------o--------X-B----------------o------X-Xo--------------X-------o-------------oBX------o----X-------o-------X-X-B--X----o---X
XXXXXXXX-XXXXXXX-XXXXX-XXXXXXXXXXXXXXXXXXXX-XXXXXXXXXXXXXXXXXXX-XXXXXX-XXX-XXXXXXXXXXXXXXXXXXXXXXXXXXXXXXXXXXXXXXXXXXXXXXXXXXXXXXXXXXXXXXXXXXXXXXXXXXXXXXXXXXXXXXXXXXXXXXXXXXXXXXXXXXXXXXXXXXXXXXXXXXXXX
