--------------------------------------------------------------------------------------------------------------------------------------------------------------------------------------------------------
--------------------------------------------------------------------------------------------------------------------------------------------------------------------------------------------------------
--------------------------------------------------------------------------------------------------------------------------------------------------------------------------------------------------------
-MM-----oX----------------X-X--B-----X---o---------o----Bo-------Xo----------------X-----------?----------------?--M-----------?M----XB---------M-----------------?-----Mo---?-------?-o---------?---o--
-----MX--X-------X----X---B-X---Xo----X-o-X-?M---------?-----------X---B-X----o--M---------o-------X----X-------------X-------E--?X------XM---------X-----o--------X-------------X----------------------
---M-----------X----oo-----------------------------X----o----?-----B----M----X----X--M------X------B------?-------------X---o-X-E-XM-X------------XX--------X--------------X-----------B-B-------XE-o---
-----------B------oX-------?------?-------M--------------XE---------XM--------------X-X---B-----------oX---o---?---------o------X-?-X------X---X---X-oM----M-oX---o----?---XX-o----------X--o----X------
-----B-----B--M------X---------?------------------o-----M------B--------o------M?o-----o-X-------------o---XX------?----M-----M--------X----X---X-----o--------??---------?X---X-X-------B-o---?---B---v
------XB--------M---o--X--M-------o-?----------------------M---M--------o--M-----------X----------------------B--o---------X--------XM--?-?--o-----M------X--------M-----------------XX----------------f
--------B----------X-X-X-------------------------M-?-----------o---M--------------------X--MX-?-------BX--o---------M----X----MB--M-X----X--X--------?---------o--------B?-------X-----o--X----X-------f
--B-X----------o--oo----X--B-X-------X----X---B-------E-----X----------------o-------------?o---------?-B---X-------------------o----o--Bo-E----------X-----MM------M------------o--?------------X----Xf
---XXX-X--BX-----X--o-X-X-XXXXX-X-XX--oX---X---XX---XBX-X-XX--X-XX---X---X-XX--XXX-X-----B--X-BXX-?-E--X--XX--X--XXX---X-XXMX?----o-M------?--o-------o---------------X-?--M-oX--o------------o--------f
-------X-M------------B-----X--X--------o-------------------------------------B-----X---X-------------------o-----M------------X-oX-----X---------o----X-?---o---B---------o-----XXM-o-o-----XX?----X--f
----------?----------X-----?----------X----M-o----?--E-?-B---oXo----o--o----------------o----------X--XX-o--------?------?------X-------o-----o-----?----------?o----XB-----M--X-----BBo--o-------X----f
m-----------------------------oX------o---X----X-----X---X-----------o-------X--X----------------------X----o----------B-----------------X------X----------------------X--------------X---------o-X---XX
XXXXXXXXXXXXXXXXX-XXXXXXXXXXXXXXXXXXXXXXXXXX-XXXX-XXXXX-XXXX-XXXXX-XXXXXXXXXX-XXXXXXXXXX-XXXXXXXXXX-XXXXXXXXXXXXXXX-XXXXXXX-XXXXXXXXXXXXXXXXXXXXXXXXXXXXXXXXXXXXXXXXXXXXXXXXXXXXXXXXXXXXXXXXXXXXXXXXXXXX
