--------------------------------------------------------------------------------------------------------------------------------------------------------------------------------------------------------
--------------------------------------------------------------------------------------------------------------------------------------------------------------------------------------------------------
--------------------------------------------------------------------------------------------------------------------------------------------------------------------------------------------------------
--------------------------------------------------------------------------------------------------------------------------------------------------------------------------------------------------------
--------------------------------------------------------------------------------------------------------------------------------------------------------------------------------------------------------
-------------------------------------------------------------------------------------------------------------------------------------------------------------------------------------------------------f
--------------------------------------------------------------------------------------------------------------------------------------------------------------------------------------------------------
--------------------------------------------------------------------------------------------------------------------------------------------------------------------------------------------------------
m------X--------------------X------X--------------------------------------------------------------------------X---------------------------------------------X---------X--------------------------------X
XX------------------------------X------X--X------------X--------------------------------------------------X------------------X--X----X-----X-----------------------------X-------------X---------------X
-------X------------X----X--X------X-X--X------------X-X------X--X-------X--XX----X------X------X--X-----XX------------X---------------X--------X-----------X----X----X---X-X----------X----XX-----X---v
-X-X--X-------XX--------X---XX---X-XX--XX----XX--X----XXX-X-XX-X-----X-XX-X--XX------XXX-X-XX-XX-X--------X-------X-X--------X---XX-X-X----X-X---X-------X-----X-----X-X-X----X-------------X--X-----X-f
-----XX---XXX-----X-X-----XX--XXX----X-X--X-----X-XXX--X----X----XXX---X--XX-XX-----XXX-XX--X--------X-XXX-X--X---X---X-XXXXX---XX-XX--X---X---X-X-XXX---------X--XXX----X--X-------XX-------XX--XXX-XXf
--------X--------------------------X-----------------------------X-----X----X----------------------X-----------X----------------------------X-----------X-----X----------------X----X-----X------------f
-----------------------------------------------------------------------X-X-----------------------------------------------------------------------------------------------------------------------------f
-------------------------------------------------------------------------------------------------------------------------------------------------------------------------------------------------------f
