--------------------------------------------------------------------------------------------------------------------------------------------------------------------------------------------------------
--------------------------------------------------------------------------------------------------------------------------------------------------------------------------------------------------------
--------------------------------------------------------------------------------------------------------------------------------------------------------------------------------------------------------
-X--BXX-----M---------------X-oX------B?-----------oX---X-M-o-----B--M------o?X----X-----o-----?B---M------o----------MM---B--X--?MX-o-------------o----o---X---o--M-o---------M-------------X------o---
------X---?-----M-M---X--------------o--------o-B-------------X--------B--o----o-------E-----------------X--------o-----X----------------X------?-------------X------o----B-------X-X--?--X-o---XM------
---X----------B----------------------------??-X------o--B---X-----X--------??--X-------X----?-----------------?------------B----X-XM-X?-----M-M--------?--X---oX------oX-----XoB?------------------M--B-
-----------B-------X-o---X--X----B-M---------------X-------------?-X---?-----X?-------o-------X----B-------o---?-ooo-----o---X------M----------------------?M-----o--------XX----X-----------X------?---
------------------------------------X-X------o-?-------X--o-o------X------------------X--Mo-------------------------X?---X--------X----------X-------o---------B-M-------X-----X------o------B---?-----v
---X-?X--X-----------X--M---X-------------o-----------------X-----------------XX------------X--------o--------B--o----E-X--------X----M--X--X------M----------X----B----X-----oo---B-M-----?B----------f
-------o-o-X--B------------M--M--?-------MB-?X-B---?-------------------X-------X--------XXM-----o-------oX--------XB--MX------X?--X-X----XXX----------XX-o-----o-----M--X--------------o-------X-X-----f
----------X--------o--B--------o-----X----------X------------o-----X-----X---o----------------X----o-E---X------------------------------X------XX-oM--------MM---X----------------M-----X--------X-B-X-f
-X----X-X--X-X-X-X-Xo--XXXXMX--XX-M-B-oX---XM?-----oX-MM-X-XX--XXX--oMXXBX-XX-X-X-XXo--ooM-X---X--X--XXXX-??XX--XX-X--MXX?-X--M------X----?--------------B-----B-----oX--X----o--------X------?--------f
---T-X---o-------------X-----------------------X--X------------------------o-X--------------------------------------X-------o---?--X--X-o------------?-X-BM-------M--o----Xo------Xo-o-E--------?------f
---|------o------?o------?------X-o-X---X----o---X------o----o-----X---oX----o----------o---B-------------oMM-----?-----------M--X--M----XB-----o-oM--X-?--X--o-M--M--------M--------BXB-X-o------X----f
mX-X----------------B-----X--------------B---o------------X---B---X--------o----------X---------X------------X-----------------XX-B-----oX----X-X---------X------X-----X-------o------X--X----XXX-X---XX
XXXXXXXXX-XXXXXXXXXXXXXXXXX-XXXXXXXXXXXXXXXXXXXXXXXXXXXXXX-XXXXX---XXXX-XXXXXXXXX-X-X-XXXXXX-XXXXXXXXXXX--XXXX-XX-XXXXXXXXXXXXXXXXXXXXXXXXXXXXXXXXXXXXXXXXXXXXXXXXXXXXXXXXXXXXXXXXXXXXXXXXXXXXXXXXXXXXXX
