--------------------------------------------------------------------------------------------------------------------------------------------------------------------------------------------------------
--------------------------------------------------------------------------------------------------------------------------------------------------------------------------------------------------------
--------------------------------------------------------------------------------------------------------------------------------------------------------------------------------------------------------
---------------B--X-------M--------XB----B---------------X------Xo---oo-X-----------M---?--?B----------B-X------X-----M----------?---B--o------XMo-B-----M-----------oX-?----------X-X------o-----------
------?--------------X--X---------M-------------?-X-Mo---B--------XX--------X------------------B--M------B---------------o-o---M--------o?-------oMo-----------------------X----------------------?-----
-M--X----B------------------X-------------M---X---------X-oo-X----------X----B--BX---X-----?Xo---------XM-X-o---X-X--------o----X?---o-----B-M-o------M----XM----X-M---?--M------M-X--------M-X?--------
------B---?--------------------------------X---o----M--o-----------M--------?-X---------?----------------o-------------------------o---M------------------X-----X-------B----X-----X-X---o--------XX-M--
-----X------XB-----M----------?MX-?--------------------o------------------------MB---?---M-----------B-----?---------B------------------X----?--X---X----o-o--X--B------------M------X-MX-o--M-X-------v
--------------M--------------------------o-----X----------X-----Mo---------M----------o-----X---M---B----M---------------X--------B-------oX----------M-?---o--o----Xo----o----o-X-o----------BB---o---f
--X---------M------X--o--------X---------o-----X--------------------XX-X-----?--------o----oX-M--o---------------o--B-X---o----?X--X-----------X----o------------------M---oo--------?-X-?-oB-----X---Xf
-----X----X---X-X----X---------B-----------X--------M------------B-------X-----------B-----------X---B-----B---------------o----o--------------X-X-X------o---oo-------------------X--X----------------f
-XXX---XXMX--XXXXX----XoBB?-XXo--X-o--X---MX--X-XX-----?B-----XX---XXX--XX---MXXXMXX-X-X--X-M-XBX-X----XXX-X-X-XooMX-X--Xo-XXMMB----o-----X-----------X----M------X------o---------X--------M-XM----M--f
------------X--------------?-------B------------X--TX------MX-X--X-----X----------X---Xo---------------o--------------B?--------------o----BMX-------X-------oX-----M------o-?-------X-------o---------f
-----X--------X------XB-?-------o---X-?--X--B-X----|B------------------X-?----------o-------------BX--X----Mo-XM--------X---X---X--------?---------o------?--X---M---M-----X--oB----X--X-----B---X---X-f
m-X---oX-----X----X----------o-------------X-----o-X----------o----X-----------B---X-------X-----X-X--------X------X------X----X----------X---B-oo-o-----------X--o------o-----X--oX--BX--X--X---------X
XXXXXXXX--XX-XXXXX-XXXXXXX-XXXXXXXXXXXXXXXXXXXXXXX-XXXXXXXXXXXXX-XXXXXXXXXXXXXXXXXXXXXXXXXX-XXXXX-XXXXXXXXXXXX-XXXXX-X-XX-XXXXX-XXXXXXXXXXXXXXXXXXXXXXXXXXXXXXXXXXXXXXXXXXXXXXXXXXXXXXXXXXXXXXXXXXXXXXXX
