--------------------------------------------------------------------------------------------------------------------------------------------------------------------------------------------------------
--------------------------------------------------------------------------------------------------------------------------------------------------------------------------------------------------------
--------------------------------------------------------------------------------------------------------------------------------------------------------------------------------------------------------
--X-----X---X-X-----------M--XB---MXM--X---M-X---X-----------oo----XX--------------M--BX-------------o---------?----?------X---?----?--X----Xo-?-X?------------------M---o--X-Bo-------------o--o-----o-
----X-o---B-----X-----X-M------X-----XB------------oo---BX--------X---M--oX----XX-------o----M--------X------X---B---X--X-o-------------Mo--X---X----X-B-o---M----oX--------o--X---o-X--E--?-----X------
---X---o---------o-------o---B---?M-------X------------------------MX-------o-X---X?----X-?--------X-M----Xo-----------------B----o-M-X--X-X--X---M-------B---M-------Xoo-X--?M-X------oX-----B-?--X-o--
----X---------------?--------------?---o----X-----B-M-o--o-X------------o------M-------X-----o--------o-XX---------o-------o----------o--------X---o--B-?X-?---B----oX--X-------XXo---o-o---------------
-------X----o---M----B--X---o-------M?-X-------o-----M----M--?-BM---?X-?-BM-----------X-X-M-----M------------------X-o-oo-----o--------M---------o-------X--X-o----------?--M------X--o-----o---o-o----v
---o----------X---o------B---X-o-o--------------------?o-------------------------M---XX------------M-------Xo-------X-X--M----------------o----o---o-?--M---oX--X-X----M-----?-X-?-------------o-------f
-M---M------o--X---------------X--B---XX-Mo---------M---------B-o-B-X------o---o-----o--------oo--------X----oM---X?B-B----X-X-?-----M------X-----o----------X--------------------oXX-----XX------X--XBf
------X---o----X-?--?----X--X---X-B-oB-B------oo--?--M-----M-------Xo-X--M?---------X-o---M----X--M---------X--B-B------X---------o-------------XM-X----------M---------------oX?------o-----------B---f
----?----o-----------MMM------o----o--B--------B------MX-------o---B-------X--o--?---------o----X------oo-------------XM------o---X-X--X------------------oo-----o?o-o-------MX-----M---------X-----o--f
-o----------X----??------X------B---M---o--X--o-----B----o-X------X-o-----B---------------o-?---------M----o------------o-X-?-X--?-B--o-------------------o-BXX------X---o-----?-----------X-XX------o-f
------?---?--o-------XX----o--?--------------B---------------XX--XXo--?--?------?o-?---------X-?------------M--?---o-----------------X---o?--B-------o---o-X------M---X---o--M--o--------X-X----o-X----f
mXX-----X----------oo--X--X------X---XB----o-------------X---oX------------X-X-------------X---------X--X--------X---X--------------oX--------X-----o---o--XX-o---------------X---X-X-X--X-X-XX---X---XX
XXX--XXXXXXXXXXXXXXXXXXXXXXXXXXXXXXXXXXXXXXXXXXXXXX-XXXXXXXX-XXXXXXX-X-XXXXXXXXXXXXXX-XXXXXXX-XXXXXXX-XXXXXXXXXX-XXX-XXXXXXXX-XXXXXXXXXXXXXXXXXXXXXXXXXXXXXXXXXXXXXXXXXXXXXXXXXXXXXXXXXXXXXXXXXXXXXXXXXX
