--------------------------------------------------------------------------------------------------------------------------------------------------------------------------------------------------------
--------------------------------------------------------------------------------------------------------------------------------------------------------------------------------------------------------
--------------------------------------------------------------------------------------------------------------------------------------------------------------------------------------------------------
--X---------------------X--------------Xo-X--Xo------o----M------M--Xo----o----B--X----M--------o?-------------M-X----------------o-X------o--o-------BX----X---oo-------X---?------M----B-----------?--
----B-----o----o--B---B--------------------------o----------M----------------------oM----X--M------X---X--------M--?---X---M-------------------oX--o-----------M----B------B---------X--------M-o--o--o-
----XX--X-----M----X-------BB-oX-----X--X-MXXX-------M-X-MM------o-?-------------B-----------?M-------?---------------B--?-----oX--X-------oB------X----o--------B-M----------X--M-X------X-B-----------
---------M--?--------?----------------Mo------M-----------------XX-----o--?-?-M--------------------M--------------------------X------------B----------------?M---------M--B-------------------------o---
-----MX---X-----B--------M-o---B---------?-------X---?----M--B--X-----X------------?--B-B-------X------o---?----------------o-X-X------M-----?M------?----------M------------------X-o--XX-?---?---Bo--v
-----------o--X-----o-B---M---Xo----Xo-X-----M---B-----------XXM----o----------o-------------------X----XX--?-M-------------------?-------------o-oX--M-X-X------?------B--------o---------------------f
-----M-X-----E-oM----X------X--------o--B---------M----o----X---o------o--B--X--------------X?M--------o---------Xo----M-------------o--o-------oX-----?-?o---o------------------BX---------oBo----X--Mf
---------M---X----------------------o--------------X---------------X-----------------o-M-------o-----o---------------X-------------B------?----o--o---------X-------M-o-E-?-o------X--X-B------M-o-----f
------X------XX-X--o--XX-XX---BBXo-X--o--XXXX---X--X-X-XXM-XX--X-o-XXX--M--XXXM-X-B--X---XX-XX-X-X--?XXXX-XXXXXXX?--X--XXXX---X---X--o-B-----oM-----X--------oXX--B---X-X----XM?--o---------------o--o-f
---------Bo----?o----------o------?--X-X----X-X--T--B-----X------B---o---------?-------B--------M--------------------------?-T-----------------------------B----B-Xo----X--------X------o-------B-oT---f
-----?------B-----X?---oo?------------o-XMM------|-----Xo---?XBX------------------X-----X--o----------M------X----X---M------|-----------X-------o--M--------?------M-B--?------X--------BX----X---|---f
m-----o--------o-------X--X-XX-------------------XX----XB-------X---BXB--X--X-o--------------o--X----------o-------X------X--X--o-X-------XB----X-X----X---o-----------X---------XoXX----X-----X---X---X
XXXXXXXXXXXXXXXXXXXXXXXXXXXXXXXXXXXX-XXXXXXXXXXX--XXX-XXXXXXXXXXXXXXXXXXXXXXXXXXX-XXXXXXXXX-XXXXXXXXX--XXXXX-XXXX-XXX-XXXXXXXXXXXXXXXXXXXXXXXXXXXXXXXXXXXXXXXXXXXXXXXXXXXXXXXXXXXXXXXXXXXXXXXXXXXXXXXXXX
