--------------------------------------------------------------------------------------------------------------------------------------------------------------------------------------------------------
--------------------------------------------------------------------------------------------------------------------------------------------------------------------------------------------------------
--------------------------------------------------------------------------------------------------------------------------------------------------------------------------------------------------------
--X---oX------?----XoX-?-X------XX-o--X---------XoX----B-----------X--X--?----X?-------B--M-----------B-----------B---M----------M-XXX-oX-X--X-?--?------?-----------MM--XX------X----o-B-------------X-
----M-----B---------------o-X--X-------?------------B--o-X-----X----------X--X----------o---X-X-?-o------------?--------B------M------------o---X------B--o-----Xo-B---XB-----------M-------?------X----
-M-----------B----o---------o-------X--------------o--B-X------Xo---------BX-Xo--XBM-----M---------oXXM--B-o------------X-B--B----XM---X-X-----oo---X--o---------------------?--B--------B----B---X-----
--X-o--------BX--o--X--------o--------X--X----X---X------------------M-----X--o-----M----------M-------------M?-?--o---o--------------o--------------B--X----------------XX----X-M--------X------X--o---
--X--o----B---o----M-?---X-MX--X--B-------M-----oXX-----M---MXXXX--X--X---M-------M-----M---oX-------o-----------------------?-----?-----M------X?---X-?o?----X-----------------------X-o-----B----X---v
-------o---------?----o-------M--------------------X----------E---B---------o--------?--------X--X--------X----Eo--X-X-o--------BX-----M---B---o----?-------o---B-X-------X---?X----XX------o?------MXof
---?----------o----?B----X-o-----X-?-----oXX-----o-----------?B--o-Xo---X-----oX-------oo--B----X-o---------?oMX-----------X-X-----------------X-X---X-o-o-XX-----o-X---X-XX?---------------------X----f
------X-X-------X------o-oX-M-M-X---o----------o-E------------------o-----o--XX--?M--Boo-----XX------------------?------M------?---X---------o--X-M--X----?------o----M--------XXXX-X-M?----M------?---f
---------------X-o--B-o-----------?o---XE---MM---X---XXX--o-B--oX----------o------------X--o----o----M--o--B--XM---?--------o----o--E----------------------o--------?-----X------------------?o--------f
-o------X-------X-?------X----------X-M-Bo---------XB-------B----o-X-B----------B?-B---?-----?-------------X--------o---------X-M--MXoo----XX-------------X----o--E--XT--X------o----XX-B-----o?----M--f
-X--o---X-----X-----B------o--o------------X----o------o---X----?-X----M-?-----------?-----X---o-----oM---M---o----o-X--X-o----------X--oo-----X----XX?X----BM--X-M---|--o--?----M-M-----X------o-X----f
mX------X------X---o---X-------X-----X--o----------X----B------------X-----XXX-X------X----X----X---------------BX---o-X---X--------oX------B------------------X------X--X------------B--X-X--B---BX--XX
XX-X--XXX-XXXXXXXXXXXXX-XXXXXXXXXXXX-XXXXX-X-XXXXXXXXXX-XXXXXXXXXXX-XXXXX-XXXXXXXXXXXXXXXXXXXXXXXXXXXXXXXXXXXXXXXXXXXX-XXXX-XXXXXXXXXXXXXXXXXXXXXXXXXXXXXXXXXXXXXXXXXXXXXXXXXXXXXXXXXXXXXXXXXXXXXXXXXXXX
