--------------------------------------------------------------------------------------------------------------------------------------------------------------------------------------------------------
--------------------------------------------------------------------------------------------------------------------------------------------------------------------------------------------------------
--------------------------------------------------------------------------------------------------------------------------------------------------------------------------------------------------------
--?o--o-?-M-----------o--------X-X?o-----------BX------------?oB-M-MM?--------M?-------------XX-X-----------------MM------------E--X---??------?-----E-------B--??B----X-------------------------o---oX-
-----------X-----o-X-B-----X-X------M----o---------MBo---?B-------------X---B---------?X?o--X-B-------X--------------X-MXB-Xo-X?X----?------o---X----X-Bo-o---------B-XX-X---------------X---o-----X----
----X--------M----oX-----?----------------X-o---------B----B---X-----------X-o--?X-M--------o--M-?-----X----M-X----Xo---B-X--B---o----XX---X---X-----X-oX-B--MX-o-------o--o-o--B-----?--XB---B---X-----
--X----X---X--XB-----?-X----o-X-------M--X-M-----X---o-------M---X---------X-----B----------------E--?-------o--?------o--B----B-----X---?-B-X-------------?------XM--M---X------?--X--?---------X--Mo--
--o--o----B--?-----?-----X-X-----X-----X---------X------X------MX-------X------------M-BX------X-XXX-----Xo------oBXX-X-o-----X--o-----o--B------o------------X-o---X---X-oo------------Mo--------M----v
-?---X----------------o-------?-o-o--X--------o-X-o---------X----------M----X-----------------X---------X-X---B-X-------------------------o-o-M--o--?----oE-o----M---X----------X---X--------XM----BMM-f
--------------o--o--?------o?-----------------o---------X-----------o-----------o----X-o?-------M---M-------------M---M-M-X-oB--------------------B-------XX-o-M----o---X-----o----------------X-X-----f
---X--B----------------o--X-----M-X--ooM----X--------M---------X----------M--X-?--o---o--X---XX-----------M--------------o-----------o-------o-oMo---o-------o---X----MB-M-----XBM-----o-X-----oX----M-f
----------o-M--X--X-----X---------------X-------------X--XX---------X---o--o--------------------o----M--?--oB-----------------?----------------------------X--------X--o-----X------------X---o--------f
-M---X--X------BX--------X---M------B-------B------T-----Xo-BE-----X-----------oX-------M----X---B------------------o----o-----Xo--XX------X----o-----o--------o---?-XX-------oX-----X--BX-----?---XMMBf
----o-Mo---B-X-------?M-----------?--M--------?-oo-|-------X-XX-X-----X--?B----o-oX--------X-X-o-----X-BX------X-o----oX--o--X----XX-o---ooX-M-X-------?---X-----------B-o---X---o-Xoo---X------MoX----f
m-o-X----X----X----B------X--XX-o-------o----------X-------------------X-----X-------X-X-X-B-----B---------------X-----X-------X---------X----X----------------o-------X-X-XX--o---------B---X----XX---X
XXXXXX-XXXXXXX-XXXXXXXXXXXXXXXXXXXXX---XXXXXXXXXXXXXX-XX-XXXXXXXXXXXXXXX--XXXX-XX-XXXXXXXXXXXXXXXXXXXXX-X-XXXXX-XXXXXXX-XXXXXXXXXXXXXXXXXXXXXXXXXXXXXXXXXXXXXXXXXXXXXXXXXXXXXXXXXXXXXXXXXXXXXXXXXXXXXXXX
