--------------------------------------------------------------------------------------------------------------------------------------------------------------------------------------------------------
--------------------------------------------------------------------------------------------------------------------------------------------------------------------------------------------------------
--------------------------------------------------------------------------------------------------------------------------------------------------------------------------------------------------------
---B-------B-----M--------------------------?---X----BXX--M--X-X-------------------------------------X-----------M-X------------?X---o--------------------oXB-------------B-Xo----------B-------------M-
-------------------MX---------o------?------------X---o-o--X-X--o---MX-----Xo-B--o---------X--------B----B--------------------X-----------X----?-M-o----o---------------------------------X--------M----
-oX--------X-----------X----------------X-?--X-------X-----o--------------------X-M-M?----o--X--o--B-Bo---X?-----M??-------------B----X-o-o-B----------------X--Xo-------X--X--Xo-----X----X---o--------
--------X--------XM---o----o--------XX----------oM------------X----o-M---XM-?--------------------X---------------------X-----------X-o---------B----?X-----X--M---?M-----B---XB---------M---o---o---X---
-----o-oX---o--?-------?-----------------------B---------?------M--------------------X?-------o----------Bo-Bo---X--o-----?-o-MB-M-----o----o---o-----B----X--------X------------M------------B--?-----v
-o-----------------X------oB---BX--------X--B---o----oM-------M------XX-B-------X-o-------------X--------oo-------M-------------------?-----------o----------------o--XX------?-------------o----------f
-X----?----M----B----------o-------M-------oo---X---------B----B-----------X---X---o-------B-XB------------Mo----------?-------------------?-?M---X----B---------X---Mo---B-X---X---B-----X------X-----f
--------------------X---M-------------------------M---BM---M-------X---?-------o-M---X---------------M------------o---------------M?-?-------------oM--o-X---M-?--?--------------X---Mo-o-------X------f
---------------Xo----o?---M------------?--------o----X-------M-------M---------------o---------X--Xo---------X-----------?------?------X-o---MM--X---XM-X----------?---?--BB-B--o-X----M-M--M--X-------f
-------------X---------?M----------?-----X-?X-----X----M-X-M--?-B----------X-B--------BM----------------XoM----o-B--o--------?----?-------------ooX--------M--BB----X--------B-B----------o---X--X-M---f
--------B---X----o--o---------------?--------X--------------o---o------------X-X-M---o----?---------?------X-------------o------------o--B-----M---X---oB---X----?------BMo----oX------XX---X---XX---XBf
m--BX-o--------X-----X---B--XB---------o----X----X--X-X---------------------------XX------------------o---B------X--X-------------X---------X-----X---X------------X-X----X-X-------X-----X-----XoX----X
XXXXXXXXXXXXXXX-XXXXXXXXXXXXXX--XXXXXXXXXXXXXXXXXXXXX-XXXXXXXXXXXXXXXXXX-XX-XXXXXX-XXXXXXX-XXXXXXXXXXXXXXXXXXXXXX-XXXX-XX-XX-XXXXXXXXXXXXXXXXXXXXXXXXXXXXXXXXXXXXXXXXXXXXXXXXXXXXXXXXXXXXXXXXXXXXXXXXXXX
