--------------------------------------------------------------------------------------------------------------------------------------------------------------------------------------------------------
--------------------------------------------------------------------------------------------------------------------------------------------------------------------------------------------------------
--------------------------------------------------------------------------------------------------------------------------------------------------------------------------------------------------------
--------XXX-MM--?----B--M---------B---o---o--?--o----o-X-o----o-M--B---------o-XB---?-----------------------Xo----o--M-------------X-X-X--o----M------------X--X---oX------B--o----X---X-----------XB---
-M----B----------------------X-X-------X-o-o----------X-------B--B-----?X--------X----------------M-------X--XX--------X---B---B--------o----o---o---o-B----o-o------X--------XM-------------B--Xo----?-
-----B-----X-X---X-oB---o-Xo--X--X-oX--------------B-------B-M----XBoX--o---X----o---X?E----o------Bo----o-----B---o------o----o--?---XB--?-X-----X------X-----X-X-------oX-X----oXB---o-?--------?-----
-oB-X-oX-X-----M-o----X----X----X------X---------------X--?---M--------------M-XB-X----B------oo--X--?---------o-----------X----o---o-----------o--X-?-----X------?-M-X---X--Xo-------?----M-B--o-----?-
----o-X------o--o--o-B--------------X-----MXB-o-?----B-----o------------X--X--X----oo----B--?----X----o----------o--o?-M---------B---oo------BX--M-----o-BX-M--o-----M---X----X-B------o----oB?----o---v
---o------o-X---o-o--XB--M-XBB-X---X-o--X--------o----BX-o---o-B--?-------X--------------------X-------------o--X--X-------------oB-----?--X--E-----X--X-------X---------------------BXX------------X-Xf
--B----XB-----o-------X------o---B?---B---M-X---X-------------B---------------------o--M-------X---------o-o-X-?-----o---------X--o----------XX--XM--X---X---o--Bo---X-----B---------o----X-o-o---B--X-f
-----o-X-----o-----?---B-------------------o---o----o---------X?-?--o-XX-X--X--------o------M------B--o?-X------------?--X---o-----------X---------------XX--------o--X-o-X-?o----X-----oo------X------f
--X---------o---o---------XM-XX---?---X------oM-----o--o-----X-----?-E---o-------XX-o-oX--X----oX-------?----------X----------X----o-?-----o---------o-o---M-----o-----------------oo---------?-Xo-B--of
---X---M--B-o--X---------o-----?--------o---o--------o-----o?---oB--XB----M-----X----XX---oX-oo-----B---------XXo-------X-o--------X---o--X-XB----o----o-----o-X--X---o-----Xo-TB----B---X-X---------B-f
-o--Xo-------o---o-X-o------oB-----------X-X-----------o-XX--B---X---X------------X--B-----X----?-------o---oo---?-X-XMX----o----X--o------X----o---XoX-------------------X----|---B----X--X-X----X----f
m------X-----------------------X-----X------B--------XXX---------o--X-------X-----------X--------------oX--------------XX-------XX------Bo-oB---------o----X--XX----X------X-XoX---X-------Bo-oX--X----X
X-XXXXXXXXXXXXX-X-XXXXXXXXXX-XXXXXXXXXXXXXXXXXXXXXX-X-XXXXXX-XXXXXXXXXXXXXXX-XXXXXXXXXXXXXXXXXXXXXXXXXXXXXXXXXXXXX-XX-XXXXXXXXX-XXXXXXXXXXXXXXXXXXXXXXXXXXXXXXXXXXXXXXXXXXXXXXXXXXXXXXXXXXXXXXXXXXXXXXXX
