--------------------------------------------------------------------------------------------------------------------------------------------------------------------------------------------------------
--------------------------------------------------------------------------------------------------------------------------------------------------------------------------------------------------------
--------------------------------------------------------------------------------------------------------------------------------------------------------------------------------------------------------
--B-----oXX----o-X?M--ooo---oo--o-X---o---M-----o--------?----X--XBX-X-------X--XX-------o----X-B---MM--o---X-o-?-------o--XX----X--o-----o---o---------B-o--------oX--M---B----M-X---XX------o--B--BX--
----B--B-------------o---oB--X-----X--------oX-?o-----o-------o------o----o-------------M-B------BX---X-oX---XX--XXoX-XXoo------?--X----B---Mo--oo-oXo-XX---o-o---X--B--X-X---?---X-o-o-Bo-MB--------X?-
-?---BMo-o-X-X--------X-------X---o-XoXX----------XMB--o--BoX-------M---?-X--X----XM--o-----o--oX--BoX-X--M----X----X------BXX-------BoX-MX----------B---?-X---X-M-B------------Xo----------------------
--------?X----------o-----?--------?--------o--Bo----M--B--------M---M-----------------B--XB------B-----X-----------------o---oXM-Mo-------X-o------B-------X----------o-------------oB----X--Xoo-----X-
-------------------o-o-B------X-----B------o----XX-X-------X-------M--?--X--X---XMoM--X-XB--o----------?o-X-------o--X--oB--------------o---o----?B----X-BXXX-o--o----X-----M-XBB--Mo--X----o-X--X-B---v
---M--E-----o-B--X--B--X-X---------o-o-X-------M-------------o----------XB-M-M-X------------BXX---B--------oo--X------o?---M--o--M-----X-------o---XM--X-X---o-X---Mo---oB----X-----------Xo----o-----Mf
------M-M----Mo-M-MB------o--?----X---M---o--o--------X---XM----oB-?-----------o-------X-----o-X-o-X-o-------o----------?M-----X------oo-----X----M--B-------o--?----M---o--Mo------------------X-M-X--f
-----------X-------BB-B----B--o--o-------?oM-------X----------o?-o----o-XX----o----oB-M-------B--XX------XX---------oX-----o--------------B-X-------o-o--XX?-------X----------o--X-------X-o---X----X-of
----X-o-------X---------------o-----ooX-------X-----o----?B--------X-X-?---X----X---B-------o-------------------?-X---M-------X-----X--X---X-------------o----XM-B-------o---------BB--------B-----X---f
-------M---o---X--B--X-----o-----o--X--o-----X----BX--?------X-oo-----------BX--------X-X-o-XoM-----M--------o------------o-------Mo--X-o-B------o---------------o---X------XoB--E-------oX-B--X-------f
-Xoo----o-?B---B-----o-B-M---XB---X-----oB-------o-----oo--o-XoXo-o---o-B---o-?-----X---X---------o--oX--o--BX-----X------X-o-XX----o--?-------o-----B--X--XM--X--EX-X--o-X---o-BX-----X---X-o----X----f
m--o--------X-----X--X-X----------X---------X----o-----------Xo----o--------X---------X---------------X--------o--X-----------X-B--X-------o----X-o----o-------oB-B-B-o------Xo---o------B-X--oX-XX---XX
XXXX-XX-XXX-XXXXXXXXX--XXXXX-XXXXXXXX-XXXX-XXXXXXXXXXXX-XXX-XXXXXXXXXXXXXXXXXXXXXXX-XXXXXXXXXXXXXXXX-XX--X-XXXXXXXXXXX--XXXXXXXXXXXXXXXXXXXXXXXXXXXXXXXXXXXXXXXXXXXXXXXXXXXXXXXXXXXXXXXXXXXXXXXXXXXXXXXX
