--------------------------------------------------------------------------------------------------------------------------------------------------------------------------------------------------------
--------------------------------------------------------------------------------------------------------------------------------------------------------------------------------------------------------
--------------------------------------------------------------------------------------------------------------------------------------------------------------------------------------------------------
--------------------------------------------------------------------------------------------------------------------------------------------------------------------------------------------------------
--------------------------------------------------------------------------------------------------------------------------------------------------------------------------------------------------------
--------------------------------------------------------------------------------------------------------------------------------------------------------------------------------------------------------
-------------------------------------------------------------------------------------------------------------------------------------------------------------------------------------------------------f
--------------------------------------------------------------------------------------------------------------------------------------------------------------------------------------------------------
----------------------------X-----------X--------------X-------------------X----------------------------------X---------------------------------X------------------------------------------------------f
---X----------------X-X-------X-----X------------------X-X------X-----------------------------------------X--X----------X-----X---X--X-----X-----------------------------X--------------X--------------f
-------X-XX-----X--------X-XX--X--------X--XXXX-X-----X-------X----X-----X-X------X------XX---X---XX---X-X----------X--X---X-----------X----X---X-X--------------X--XXXX--X-X---X--------X--X----X-X---f
m--X-X--X---X-XX--X--X--X----X----XXX---X--X-XX-------XXXX---XX-XX-X-XXX-XX---XX---X-XXX------XXX-XX------XXX-X-XX-X-------X-XXX--X-X-X---X--XX------X-X-------X-------X-----------X-----X-----X-----X-X
X-X--XX---XXX-------X----------X--X--X---X---------X-------XX------XX--X---X--X-----XXX-X-XX-X----------X--X------X---X--XXX-----XX--------XXX-X-X-XX-X--X---------------X--------XXXX--X-X-X----XXX-X-X
--------X--------------------------X------------X----------------------X---------------------------X-----------X----X-----------------------------------X----------------------X----X-X---X------------v
-------------------------------------------------------------------------------------------------------------------------------------------------------------------------------------------------------f
-------------------------------------------------------------------------------------------------------------------------------------------------------------------------------------------------------f
