--------------------------------------------------------------------------------------------------------------------------------------------------------------------------------------------------------
--------------------------------------------------------------------------------------------------------------------------------------------------------------------------------------------------------
--------------------------------------------------------------------------------------------------------------------------------------------------------------------------------------------------------
---------B---------------------------------------------------X----------------------------------M-X-----X------X----------------------?------------------M---------------------------------------?------
-----------------------X--------------oX-------------oo----------M------------o--?------?o------------X-----------o----------------M--o-----------?-------B------------X------?----------------o----o---
----X--?-------------?-------?-----?--------?----------X-------?---------?-?----?-----------BX-------------------------?---o---X------X----------------------o----X--------MX--------?------------------
----------o-------X----------?----------------------------------------------------------?--------?--------o-----o----------M--------M--?-o---------------------------?---------------X------M-----------
--M--X---X-----------------------------o-------------M---?-----------?--M-----------------------------------------------o----------o-----------X-----------------------------B-----?--------?----B-----v
----------------------------X------------------------B--?-M-----------------------------------------o---------XX--M--------M-X-------------?--------B------------X------------------M--?---------------f
------------------X---------M------M-------X--------------------------------------------------M------?-----?--------------------X-----------------o?----------M------------------------------o---X-----f
--------o------------------M----------------------------------B--------X---X-o--------------------------------------------------X-------------------o-----------M---------X---X-----o-----------M--o---f
---------------X------o-X--XX---------X------o--------XX-----X---?-------?--------X-----XM----X-----------X-X-------------X-X---------------------X?--------------M------M---------B-------X-?-------?-f
------------oM----------------?-------------------M------?-----X--------X---------M---------?-------------M-oM------------------o-----------M------------X-M-M---------M-----X----------M--------------f
--X--------B--B-----------------?-----------------------o---------X--------X---MMX------------M------M------E-------------B------B------X--o-----------------Bo-M--------?---?------M-----?-X------|---f
m-----o-----------------------------------------B------------------------------------------------------------------------------B-------o------------------------B-------o---------------X-B---X----X---X
XXXXXXXXX-XXX-XXXXXXXX-XXXXXXXXXXXXXXX-XXXXXXXXXXXXXXXXXXX-X-XXXX--XXXX-XXXXXXXXXXXXXXXXXXXXXXXXXXXXXXX-XXX-XX-XXXXXXXXXXX-XXXX-XXXXXXXXXXXXXXXXXXXXXXXXXXXXXXXXXXXXXXXXXXXXXXXXXXXXXXXXXXXXXXXXXXXXXXXX
