--------------------------------------------------------------------------------------------------------------------------------------------------------------------------------------------------------
--------------------------------------------------------------------------------------------------------------------------------------------------------------------------------------------------------
--------------------------------------------------------------------------------------------------------------------------------------------------------------------------------------------------------
-?-------------------o---M---X---?-----------M--X-------------o--------------X-----------M--------------X-------X-------M---------M----X---?o--?-----M----o-B----B--X------M--?-M---?-o--o-X---M--------
---------------------o-X------------------X-----------o-?---BB----X-------X----X---?---M------X-------?-o--?----------X-------------B----o---X-----X---------------------X---------E-----o--M----o----X-
----X---?-XM-X-?--------X-?---?---X--X--X--M-o--X----------M---------XX-Xo------X---?-----o--M-----------M--------?----------X-------B----?-X----X---M------X-X-----------X----o---XB------------B------
---X---------------o?--X--------------------?----B------M-------X--?----------------------------o-?o-?-----M---X?-----X?---o--oX--XX?B-----o-----B-X--M--X--------B----o----------o----X--------M--X----
-?---o-------B----X------------------B-o---------------------M--------X----------M---------X---X-------------------M----oB------BM-----o-----X-o---------X---X-X--------X----X-----MX?------?----o-----v
---------------?-X-M-oB----M-----------X-X---oBM-----X--XB-X----------X-----X------------MB-----X--------o-o---------------o-o----X-------o-------------X-?---?-----o-X--------o-------o-------?-X---M-f
-?-B----oM--M----X-E---X-B------B---------------------B--------o--------?------------o----X--------o--------------------Mo------o--M----------M---X----o-------?---X-------------X-----o--X--o---------f
--X----X--?-----X--M-o--X---------B---o-B-BX--?--?---M-----------------------------?--------X-----M----------X--o----oM--------o--------o-------M--o-----X-o----?--o------M--XM-?B---oo-----------o---Mf
-?---o---------o-M-------oX--------?o--X---oB---------M--?---------X------------M---Xo--X------B---o-M--------------X---X--------M-----B------M----------X--X--------M------------XM--oX-M--M------o---f
-------------X-------------M-------------o--------------------X-o-----------X---------------oM-oX--------------o---------------B--?---------X----o------------Xo?-------------------------o---X--B--B--f
----------X-M-Xooo--XB---------------o--o---M---------?-?--X-X---?o?----X-MM---X--M------?-------X---o---BX-----o---MM-------X-----X--X--------o--------X----X-----B-M----o--X--o---X-o---------XB----Xf
m---Xo---o-----------B--X--BB------o--------------X----------XX--------X-----------o------X-------X-------B------------X------XX--XX---X---XXX----X-B-----X---X---XB--X-X-X---------X--Xo-X-oX--X-B--oXX
XXXXXXXXXXXXXXXXXXX-XXXXXXXXXXXXXXXXXXXXXXXXXXXXXXX-X-XXXXXXXXXX-XXXXXXX-X-X-XXXXXXXXXXXXXXXXXXXXX-XX-XXXXXXX-X-XX-XXXXXXXXXXXXXXXXXXXXXXXXXXXXXXXXXXXXXXXXXXXXXXXXXXXXXXXXXXXXXXXXXXXXXXXXXXXXXXXXXXXXX
