--------------------------------------------------------------------------------------------------------------------------------------------------------------------------------------------------------
--------------------------------------------------------------------------------------------------------------------------------------------------------------------------------------------------------
--------------------------------------------------------------------------------------------------------------------------------------------------------------------------------------------------------
---?oX-o-X----o----o-?---------B------?---X-M--oM-------B----X---X--o-------------B-------X----X--o-------------?---XB---MX----------oB----X--------------------M-?--XB-oo---?B------?---------XX-------
------X----------------X----o-------X---?X---X---E---B----o------------B-X-----X-B-X-----X-------?--X?X----------?----X------------XX-------------------o----------X------------------M-o----------?----
---M--------X--X----------B--M---XX-----------X--X-X----o-----o---X-----M-o--X----X---------?------------------------------X--X-----------X-oMo---X---------B------o---------M-Bo--?---B-B--X---------B-
--------B---------o-----o---------------?-M-o---o----o---X------X---X---------o?------X----------X-----X-------?-----B------M---X-M------B---------X-o--------X---?-------X---X------X-----o-----X------
-----B---X----------?----------------------M---------X-------X----------o-oX---------X-o----Mo----X---?o----------------o--------------o----X---X-----o-----?X-o---------X-X---X-M-------------?---BX--v
---X--MX--o------------XX-----o--oX-----------X---o---------X---o-----------------o-----------------------------X?------B----M------X--X--?---------------X-----X-----?XX------X-----------o-----o-----f
-----------------------X-------M---M---------------?o----------o---M---BoMM--B--------------X------------?---------XM----X----M---o-----------X-----------oM---o--------B------------M-Mo-X---M--------f
----B----------o--------X-------------o---XE---X----------------------------------X------X----o---o--Xo------------------X------------XXB---B------X--X-X---------o-------------o-B---------o-----?---Xf
--XXXX-X---X?-X-MX-MM-XX-X--X---X--X-?XX---X--XXM--X-BXB-XX--X-X-X-X-XXX-X-X--X------X-X-BX-XXXXXX-XX--XX?-XX-X---X----X---X-XXM----X-----??--o-----?----?--?-------BXo--??--oX--o-----------B-E-------f
-------X-M-------------------------------?-------------X?---------X-M---M-X--BB--o------X-------BX------------------------------X-X-E-X-X---?----------X-------------------------XX--o--------XX----X--f
-o----------------?-----M--B---------X-------X-----------B---oXo?--------?-?-------B----o-?---------B-XX-Mo---------------?---------M----------------B------o--?oB----M---X----X---BX-XoX-X--?---?X----f
mX-------X----o-----------X---oo---------------X-o-----------------X-o----------o------------X---X--------X-----------B------------------X-X----o-X--o------X----------o-------o------X----X--X---X---XX
XXX-XXXXXXXXXXXXX--XXXX-XX-XXXXXX-XXXXXXXXXXXXXXXXXXXXXXXXXXXXXXXXXXXX--XXXXXXXXXXXXX-XXXXX-XXX-XXXX-XXXXXXXX-XXXXX-XXXX-XXXXXXXXXXXXXXXXXXXXXXXXXXXXXXXXXXXXXXXXXXXXXXXXXXXXXXXXXXXXXXXXXXXXXXXXXXXXXXX
