--------------------------------------------------------------------------------------------------------------------------------------------------------------------------------------------------------
--------------------------------------------------------------------------------------------------------------------------------------------------------------------------------------------------------
--------------------------------------------------------------------------------------------------------------------------------------------------------------------------------------------------------
-----o-M-----?--X--B-----------B-----X--------X-X-o--?--o--------------------------?----XMo---X?----B-?--X----M--------?---------B---o--o-------X----M-------??-o--o-------M--MX---------?----X---------
--?-----B-------X----B-X-----------X----------X-EX-X--?------------X---M-------oX-----o----o-B----o-----X-------X-?-----?---o--X-B---X-X--M------------B-X----------oB----------------B---X-------?-----
-------?-B--?----M--X---------?---o-----X--M---X?------B--X-Xo------------?--B--X------------------------X--X-M------------X------------X----o-----MBXM-X---?o-o---------X---XM--------------MMX---?----
---------------------o------X-----X---------?------M-X---------------o------------o--X---o------?---------------M--o---M-X-------M--o-B----X---X?------X---------------M----------Mo---X-o-o------------
--------XX-X-------o-XX--X----------?--?M-------oM-----------M---o----?----------Xo-----X-----X----------o----------------B----M-------X-X--X----X-------------------------X--oX---B----X------B------ov
--M---o---?--------------------------o------------X----?X-----------------?o--------------------X-----B-X-------?---M-------------------?-----M-o-------o-?-?BX----?--?--BX----------X-o----o----------f
-------?-------MM---X-----X----B-X----X---X-------------------o--?---------------B?-B---X-----o----XXX---X--X-------------M--B-?---o-o-----------B----B-------Xo-------B--XXB?------?X-o--o--XM--------f
------------oX----o-o----o-----------o---------o------X-----------------XB----------o----------------oX-X---------X--------------X-----M----o-------X-o-----M----X-------B-----X--M---E-M---------?---Xf
-XX-X-------X--X--XM---XX-XMM-X-X-X---XXXX--X?-X-BB?XX-M--X-X-X-X--X---X-XXX-X-M--XX--XX-X-XoX---XX---oX--X---X--XXX-XX-M-XX-XX---o------X------------------------o------X---Xo-------X---o-----------of
------X-o-----o--o-------------X----------B---------------o--------X-Bo----o----------o--------------------X-o--------X--?-------B---M----o--------o--MX---?-----X--M-----Bo------ooXo--Xo-X-------X---f
--M----------o------B--------------o-XX---X----X-X---------X-o--------o-o-------------------------------MM----------B------X--MM-B-o--B-o--X---oX--------B---M--------BX------o-o--B--XB--o-------X----f
m------o--o---o------B-----X--X----o--X--------------X-BX----X---B------------Bo------------X--------------B----XX----------------------oXX----oXo---o--X------o--XX-----o--B-o------XX--B--X-----X----X
X-XXXXXXXXXXXXXXXXXXXXXXX-XXXX-XXXXXXXXXXXXXXXXXXXXXXXXXXXXXXXXXXXXXXXXX-X-XXXXXXXXXXXXXXXXXXXXXXX-XXXXXXXXXXXXXXX-XXXXXX-XXXX--XXXXXXXXXXXXXXXXXXXXXXXXXXXXXXXXXXXXXXXXXXXXXXXXXXXXXXXXXXXXXXXXXXXXXXXX
