--------------------------------------------------------------------------------------------------------------------------------------------------------------------------------------------------------
--------------------------------------------------------------------------------------------------------------------------------------------------------------------------------------------------------
--------------------------------------------------------------------------------------------------------------------------------------------------------------------------------------------------------
------B----------X-----o-----------X-------X----X-?-----?--oBM---oMo-X--E---o----X---o----B----M--------oMXo-----XX---B-MooB-o---------M----B-o?----o--o---oXM-M-?----o-----B-oo--------------M-o----XM-
--------------------?----X--o----XMX------------X----B----B-------------?--X-o-----X-------X---------------------B----------XX-------B--MMX-----------?XX-B---------o-----XX-X----X------M-----X--------
-----B-----?---------------?---B------M-X-----X---------------X------o---o-----X----XX-X------X--M-X----------oo---M-X--------o-------------BX--B------------o--------oX----------------------B-oo--X-?-
---XX----------------o------M----------?----Xooo-XXB-----X--Xo-o----M----------X-X----MX-------X-------?--X-----------B----o-?-X---M-----------------o--X-o---X------X--X-M--------oX-------------------
---o--------X-o--X-M---oo-M--X-?------------------XXo--X--M-----------X-o-X-------oo------?M?XX----X----o-o---------X-----------X------M--X------oX-oo-?----------M?-----------------X--X--oo--------o-v
--X-------o------------------------Xo--------BB-------XX------B------M-------M-----o--X------B-------B------Xo-----X---?-o-----M---?o---Eo--B-?---oBX-----M----M-----------M------?X--X---o---X-o------f
----B---X------o--X-X------o---X?-----------X--------o---Mo---oo--------o------------X--?-X----X-----------o-----o--M---?X--?----X--o---B------------Bo----B-o---X--------------------o-?---X--X---X---f
---o------X-X----X-XBoX--Bo-------X----o-----oXX---X---------X--Bo--X----Xo--X--------X---X----------oX----X-----------------o--------M----B---X-----X-X-M-o---XMo-------X-X---ooo-B----------X-o------f
-M---Xo----------X-----------------------XB---X-------XM--o-B--B--------o------------o-oo------o---------o-------?--o-X--o-------M-------?----X----XX-----B-oXo-------o-----oX--o--------X-X-X--X-B---Bf
------------------------oB----XX--------?-o---------------X------XXXM----?-------------B---o-------o-------BX-----M---X----B---o--BX---X-----M--?-------XX---------B--B-BX-----------X?--X?---X----?--Xf
-B---X-----X-?-oM-----?-----B--X----o----------------o--BX--?B-X-o----o?--XX---o-X---------------------X---o---X----o-----------??--o-MX--X---o----XoB-o---X-------BM-----------MX--o---X--o---X-----X-f
m----XX-o-------------------X--B----------o-------o-------------B---o---------X--------------X----------------------------X--X----------X--X-XX--o-------X--X--o--------------X--B-----B--X--X-X-BX--o-X
XXXXX-XXXXX-XXXXXXXX-XXXXXX-X-XXXXXX-XXXX-XXXX-XXXXXXXXXXXXXXXXXXXXXX-XXXXXXXXXXXXXXXX--X-XXXXXX-X-XXXX-XXX-XXXXXXXXXXX-XXXXXXXXXXXXXXXXXXXXXXXXXXXXXXXXXXXXXXXXXXXXXXXXXXXXXXXXXXXXXXXXXXXXXXXXXXXXXXXX
