--------------------------------------------------------------------------------------------------------------------------------------------------------------------------------------------------------
--------------------------------------------------------------------------------------------------------------------------------------------------------------------------------------------------------
--------------------------------------------------------------------------------------------------------------------------------------------------------------------------------------------------------
--X-B---------?-----o-----------------XX--M----X-------------B------?-o------?------------o-?XX-X---------o---o-----?----X-----o?----o-XX-o---------?---B---o------X-ooM------Xo--oo--X-----o-------X---
-?--B------------X-X-X------o----------------------------------X--------M-B----------XX-B------M---XX---?---M---------o?-----XX---XX--M--B---B----o-------oM---X--o---------o----B---MX--------X-??-----
---X----X-------------X-B------?-------------------o-X-------?-X---B-X-----M---?----M-X---?----------X---X----X-M-------M-BM---B-----------------------o----X--B-o-o---X--X-----X--M----XB---o-------o--
--------------X--------?-------------M-----?BB-X----o---------------------------oM------?-----------M---oo---oo----------B-------------X-------o--?-------o---------X---------------------o--------oB---
---------?--o-o-----------------------o---------------M-XMB-----X-?o--B-----Xo----X----------XB--o----------X---o-X---M----M----o-o----o--o--X-----o----o--------X----B----oM---o---B--X------------oo-v
---o---B------------o---Xo---o------------X--------B------------------X---X------------M----------oX--X--X-------oX----M-------------------X-o--B----B------?-----B-B-----B--X-----o-?-------?--X------f
-XM----X------B---M----------------XM------?Xo-M----XX-------o-o------------XXX--------------------X---XooB----------------XX?---o-o---M-------M-------------------M-B--------M-MX------X--M------o----f
--------X--------------Mo----M---?----------B---X--X-------M--o---------B----------------------------------M-----------oo------o-----M----X-------?-------M------o-----oM---o------X-------------?---X-f
-----------o--?---o--------X-----------o------------oo--------------M-----M--?----------X-----?-o---o-o-?---X-o---B?------------X-----------B---------o----X-XX----XM-?--X-o------X-M---------B-----X--f
-oXX---------------B-------------------X--------M------X--o-o--------X-M----------o------------------------------M---?----B---------------X-----------------------------------X---------X--o---o-------f
-------?--M-----------M-o--o-------X---------X---MM-------------X--------XX---o---o----X---X--X----X--MX-------o--?-----------o---X---M?X--------MM---------B-X--o?----X--o--XXX-B-----XX-X--X---------f
m-----------------X----X-----B----oXB----X-X-X--------X-X-------X------X-X-----------X----X-X--B----X---X------X--------------------------Xo-B-X------X-o--X-X-X----X-------o--X----B--B-X--X-X-B-B-XX-X
XXXXXX-XXXX-XXXX--XXXXXXXXXXXXX-X-XXXX-XXXXXXXXXXXXXXXXXXXXXXXXXXXXXXXXX-XXXXXXXXXXXXXXXXXXXXXXXXXXXXXXXXXXXXX-XXX-XX--XXXXXXXXXXXXXXXXXXXXXXXXXXXXXXXXXXXXXXXXXXXXXXXXXXXXXXXXXXXXXXXXXXXXXXXXXXXXXXXXX
