--------------------------------------------------------------------------------------------------------------------------------------------------------------------------------------------------------
--------------------------------------------------------------------------------------------------------------------------------------------------------------------------------------------------------
--------------------------------------------------------------------------------------------------------------------------------------------------------------------------------------------------------
--------------------------------------------------------------------------------------------------------------------------------------------------------------------------------------------------------
--------------------------------------------------------------------------------------------------------------------------------------------------------------------------------------------------------
--------------------------------------------------------------------------------------------------------------------------------------------------------------------------------------------------------
-------------------------------------------------------------------------------------------------------------------------------------------------------------------------------------------------------f
--------------------------------------------------------------------------------------------------------------------------------------------------------------------------------------------------------
m------------------------X--------------------------X-XX---------------------------X-----------------------------X-------------------X-------------------------X-----------------------------X---------X
X-----------X----------------X------------X---X-------------------------------------------------X--------XX-----------X---X-----------------------------X-------------X--X--------------X--------------X
----------X-X------------X-X--XX---XX-----------X----XX-------X--------------X----X----X-X---------X---X-X-------XX-X-------------------------------------XX-----X--X-X---X-X---------------XX-----X---v
-X-X--XXX-----XX--------X-X-XX---X-X---XX---XXX-------X-X-X--X--X-----XX-XX--XX---X-XXXX------X-X-XX------X-----X------------X-X----XXX------X---XXX---X-X-----XX---XX--XX-XX------XX----X---X-X-----X-f
--X--XX---XXX-----X-X-----XX---X--XX-------------XXXX----X--X-----XX------XX-XX---X---X-X-XXXX---------X-X-X-----XX---X--XXXX---XXX-X------X---X-X-XX----------XX-XX-------X-----X-XXX-X------X--XXX-XXf
--------------------------X--------X--------------X--------------------X---------------------------X-----------X----X-----------------------------------X----------------------X----------X------------f
-------------------------------------------------------------------------------------------------------------------------------------------------------------------------------------------------------f
-------------------------------------------------------------------------------------------------------------------------------------------------------------------------------------------------------f
