--------------------------------------------------------------------------------------------------------------------------------------------------------------------------------------------------------
--------------------------------------------------------------------------------------------------------------------------------------------------------------------------------------------------------
--------------------------------------------------------------------------------------------------------------------------------------------------------------------------------------------------------
--X----oX-X-X-?-?----Mo----M------X---oM--------o--?-o-X-oX---o-MoXB---------o--------X-----XX--o----------oX-------XM-X---------X-?oX-X-------M----M-----X----XX--oXM-X-X-B--o------o-X-----------XB---
----X-------------?----------X-----X-----o--o---------X---X-X-----------X--------X-X---XX------X--M---?--X---XX---M---?----M---B--------o----o---o---o-BX-----?---------X-XX---?----o-----------X-M---?-
-o---B-------X-----oB---o-----X--X-oX--X--X--------B----X--B-------B-X-X------X-----B-?---oo----X---o----oM----B---o---B-------o---X-X-B-o----X---X------?-o----X--------o--------XB-?---XB-X-------o---
-------XXX----------o-----------X------X----B---------MX-----?M?----B----X--?-----------------o-X-X---X-------Xo---o-------X----o--------B-X?---o--XX------Xo-------M-----X--Xo-------?----X----o-------
----o-X--o---o--o--o-B------E-X----------?-X-oo------------o------X-----X-----X----oo-------?----X----o----X-----o--o?---o-----M--------------M--M?-------------------?--o-------M-----o-----BX----oX--v
---o------o-----o-o---B-----B--XX--X-Xoo--------o-----BM-X--Xo---------B-------X--?----------X----------M-------X----------------oB-----?--X---o---X---X-------X----------M-XB----XX-BX------X---M----Xf
--------------o--BX--oX------o-o-BX-------M-X---X-------------------------X-------------B---Eo---M---------o-X-?-------Mo------X--o----------X---XM--XX------o---o---M--o--B-----o-----?B---o-o---B--XBf
-?---X-X-X---o-----o---B---o-----B---------o---o---XoM---------M-M--o-XXMX--XBo-B--o---B---X?-----?B--o?-XM-------MX---------X?------------oX-X----------X-XX--?--B?----o-X-?X--X-------Xo-o-X-?X------f
--X---------o----o-----------X-----------o---oM--o-o---o-o---X-------X---o??---o-X--o-----X----oX--B--------------------------E---Xo-?-----o---X?----o-o--B------o------------X----X------------Xo-B--of
-------M-oB----XM--------o-------------oo--M-----X---o----------oB-----o-----X-------X-o--oX-oX-----B-----------o---M---X---o-?----o---XoX---B---oo---Xo---M-oBX--X?----?-------M?---BX--X-X---X-----B-f
---oXo--X--------X-X--------ooB-B-----o-X--------------oo----B----------X--o------X--B----------B--------M--oX---?---XM-------------o------X--------------------------M--BX--------X---XX--X-X----B---of
m------XX--o--XX-X-X-B-----X--------o-----X------o-----o---------o-------o--X------o----X------------Xoo---------------X---o-X---------oBo-oB--X-----X-o--XX--X-----X--X---X--o--X-X-------X--oX--X---XX
XXXXXXXXXX-XXXXXXXXXXXXXX--XXXX-XX-XXXXXXXX-XXXX-XX-XXXXXXXXXXXXXXXXXX-XXXXXXXXXXXXXXXXXXXXX-XXXXXXXX-XXXXXXXXXX-XXXXXXXXXXXXX-XXXXXXXXXXXXXXXXXXXXXXXXXXXXXXXXXXXXXXXXXXXXXXXXXXXXXXXXXXXXXXXXXXXXXXXXX
