--------------------------------------------------------------------------------------------------------------------------------------------------------------------------------------------------------
--------------------------------------------------------------------------------------------------------------------------------------------------------------------------------------------------------
--------------------------------------------------------------------------------------------------------------------------------------------------------------------------------------------------------
----Bo---------o?----MoM-o---M---oX----M--------o-XX-o-----BXo----XB?---------?-------X-?X-B----oB-------o--X------o--X------------?BM-o-M----------------------XXX----XX----oo----o--------------X-o---
-------oX--o--X---------X----------oBo---B--X---o-----o?----X---?-X--o--X-X-o------X-?--------o-------o------M----M-M-oXoM-----------------MM--X-----X--X--oo-o---X-----------Xo--X-o-?-B---o-X---B--X--
---B-B-X-----X---oB--------------------?--X-------------M--?-----o-----X-------B------?----oo---Bo-E---Xo-MX---B------------XX-o-Xo-XX-BX-----X---o------?-o-------o-----------ooX-B--------------------
---------X---XXX--------o----BX-X-----------o-?-XXB----------X----X-------?-B--X---------o----?X---B--X-----X-Xo-o?-------oX--XX?-X-o--------B---X----MX--o------X---B-----M-X----------?---------X---X-
---o-----o----B-o-----X---?--------M--o--M-XB----XX--------o--o-Xo-----B------------X----B--o---------o--B----------oX-B-B-o-------M----------------M------?--o---M---?--o----X-----?-------o-X----o-M-v
----------o-------o----X------X-X------?-----X-----X---M---o-B------------XXB-----o-X---o-X---------B--------oXXX-----------X--M-o--X------X---oo----X---X----o------------MXX--X-X--BX---o--X-----B---f
------M-------o---B-X-?-X-o--o--o-o--B-----------M---o---X--------B------------oM---------o--oXX-o-M-o-?----BB----------o--?-------M--oX?---o----X--o-----o-oo--Xo---M-oo--------o-B-------X--oX-XB----f
-M------XB-------------Xoo-o-------X-----Mo----o---X-XX-----X--M----oXo-M-o---o----o-oX--M----o----------?M---M-----X-----------------o-----X--------------XX---------X-X--------------?-----X-----o---f
---BX-----------------o-----oX-------o------------?---B--oX------o--XX---o-----oX--------------o---------------------?-----oX-X----M-------X-o-B-----o---o-------B-------o--------X-M?---M-----BX--X-B?f
-X-----Mo-B--M----B-T---Xoo---X--------oE-----B----B-o-----X---?---B--------Bo---o---XX----X-o------------?o------o----?X-o---------------BX--o-----M--o--Xo-o-------?XX----oM-X-------o------X--B-----f
--oo?---oM-B---o----|X------o-B-BX-?----X-oX--o------o-o-----E---?o---oB---o-B----B-BX-------XX-B-----B-----Xo--?--X-X--o---M--X--------B-------o-----X----X--o-o-BX-----X----oXB------XoX-X-oo---X-XX-f
m----X--------X--XX-XB-----------B----------X-----X----X-----X------X----o-o--X----oX--X----B--------X-o---o----------XX-X------BX---XX--o-oBX-------------X--oo----o--------X---X-B---X---X--oX--X---XX
XXXXXXX-XXXXXXXXXXXXXXXXXXXXXXXXXXXXXX--XX-XXXXXXXX-XXXXXXXXXXXXXXXXXXXXXXXXXXX-XXXXXXXXXXXXXXXX-XXXXXXXXXXXXXXXXXXXXXXXXX---X-XXXXXXXXXXXXXXXXXXXXXXXXXXXXXXXXXXXXXXXXXXXXXXXXXXXXXXXXXXXXXXXXXXXXXXXXX
