--------------------------------------------------------------------------------------------------------------------------------------------------------------------------------------------------------
--------------------------------------------------------------------------------------------------------------------------------------------------------------------------------------------------------
--------------------------------------------------------------------------------------------------------------------------------------------------------------------------------------------------------
-----?-X-------X----o?----o---X-o-B---Xo-X---X-------------------B------E------------?--------M-BX--??-?-----------BX-------o--ooX--------X---o----------XM-oB------M--o-------oM---------X---------X---
-------------------X--B---------------X---------X-X---------------------X-o--?--------------M--------E--?--X------------?---------X---M---------XXo-o-------o-----?-----------M-----B---X-BX------?-----
-B--------X-M--XM-X----o------------B---??---X-oo------o----------X--o----------------X----------X---?-----------o-------X--o-B-XB-----o-X----X-X--X--B--X-----------------B?---------?-X---o--------?--
-------?------X-------o---------------------BB--------X----o-------o-E-X-----------o--o?-------o-----------Xo-X----X---B------X-----o------M--BX---oo----------------B----------X--??-----o------M-o----
------------o-o--o-------------o-B--------o------X---M--X-----BEX--X-M-----------X-----------------X-oo------X---------X-o---o---------X-------------X--o-B----X-o-X--o----Mo-X------------B--------o--v
----o-----X--?----------M------------B--?X-------------------X-M---------?-------------X--X--o----X---B-----X-X------------------M---?-------X--oo-----M--X------B-X?---X----o--?----?o--XMXM---------Xf
-----M--X-----M---M-------o----X-----o------o?-o-X----------X-----------------?---BX---o---------M-----MMM---------------BX---X----X----------------M-------------------------X----M----X------?-X-----f
---------------------o-B-Xo-?-X-------X---------------o------o---??B---------------------o?---------?-----B-----M--?-----------oX-------------?---------o--M---X-Eo------BXo---------o-----XM----------f
----?------o-----------------oo---X-?--o----------------X--B--B---------?----X-?------M-X--------X---------oX--------------------?----------o---X----X---o-------M--BM--X---o--------X---------Xo------f
-MM------o----M----B-----------XX-----X-?-----o--o----------------B--B-------------B-------X-----X?--o-o-----X--XB--o-------?-------o---------------------------------?-------------X----o--X-oo----o--f
------------X---------M-o---o-----X-M-o-----oo-----M--Xo-------------------B-Bo-B------------B----------------B---------------------------BB-X-B--X---oX------------X----oo-----BoX---o-----X--------X-f
mB----------------X-----X------------------------------------X-X-----------------------o-X-XX---------------XX--------------------o-X--------B-B-o-X---oo----B---------o-------X----Xo-----XX-------oX-X
XXXX---XXXXXXXXXXXXXX-XXXXXXXXXXX-XXXXXXXXXXXXXXXXXX---XXX-XXXXXXXXXXXX-XXXXXXXXXXXXXX-XXX-XX-XXXXXXXXXXXXXXXXXX-XXXXXXXXXX-XXXXXXXXXXXXXXXXXXXXXXXXXXXXXXXXXXXXXXXXXXXXXXXXXXXXXXXXXXXXXXXXXXXXXXXXXXXX
