--------------------------------------------------------------------------------------------------------------------------------------------------------------------------------------------------------
--------------------------------------------------------------------------------------------------------------------------------------------------------------------------------------------------------
--------------------------------------------------------------------------------------------------------------------------------------------------------------------------------------------------------
-----o----X--B-------X-----------o-------------B-o-------M--M-----?-?o-------o-XM------BMX----X--o------X--X----?--X-----X--------------?-o------?-----X-----X-X-X--B-------X-------X---M--XMBo---------
-------oM--------X--o--MB---o-----------o---E---?-M---M------XX---------o-o-----------X---B-------?------X------------------X----X-?--------------oMo------------o------o-----X-X--------B---X------B---
-X--------X---X---X------------XM---B-M-----?------?---o----------X----E-----?-------oXo----o-M-B---X--BX---o-?X--o-----X-------o----------B--Xo-----X--------M----oo-?B--M?----o----ooBX-----M-----B---
-------?-B--X-------X--M---X-------?----oX----------M-B---Mo--------?--M---X--------?-------o---o----o----X-----B-------------X-B---o------o---XoX--o--X----X----------o?-------------X-----------------
--o--X--?-o------X------B------M----X---------X---------X--X--------------M--X----------o----------------------?------?---------------X-----------------M-----M--o-X------M-o----o-o-------B--?-oX-----v
--B-M-----------XX--?----------------B-------X----X---------XX?---M--M-------o-XM---X-o-o-?-------o---B-X---------------------B------------o------o-?---------------o-?------X--oX-----M--X----M--o--oBf
-------X------?---X--M--------X----------o-o--------?--X---M----------X---M-?----B----------X?XMB----------------Xo---------X----X--XBX?-o-X-----o---M----------?--------------o---------o-------------f
--X-----XB-----X-----------X-XX----oB-o-----B---o-----M-------B--X-------------?---MX------X---------------X-X-------------o--------o--------o----o-E----B-------M------M-M-o-oBoX---X--o-----B---B--o-f
-----------oo----o---XM----X----o--------B---------Xo--??X-------------o-----?-------------------?-B----------B----X-----o--------------------------X--XM-B---------B---------X---Xo-------M---X-o-X---f
--XX-??---M--?-------------------------------o-----------o---------o--B---o------?----XM------------X-X--------M-----X?----?---X-X--E------X------X-B-X------ooM-----X-------------o-----o--X--BB----X-f
---------------X-----------B------------XM----X---------o----X-------------M--------X----M-oX-X---X-X--X---M----M---X--------?----X-M---MM-----B------X---------?------MX----X--o?X---X-o-----M--X----Xf
m--------o--X--o---X--------------------------X---------X-X-BX---------------o-------------------------X-X---------------B--------o---------oX-B-------Xo-------------------oo----XXB-oo----X----XX--oXX
XXXXXXXXXXXXXX-XX-XXXXXXXX-XXXXXXXXXXXXXXXXXXXXXXXXXXXXXXXXXXXXXXXXXXXXXX-XXXXXXXXXXXX-XXXXXXXXXXXXXXXXXXXXXXXXXXXXXXXXX-XXXXXXXXXXXXXXXXXXXXXXXXXXXXXXXXXXXXXXXXXXXXXXXXXXXXXXXXXXXXXXXXXXXXXXXXXXXXXXX
