--------------------------------------------------------------------------------------------------------------------------------------------------------------------------------------------------------
--------------------------------------------------------------------------------------------------------------------------------------------------------------------------------------------------------
--------------------------------------------------------------------------------------------------------------------------------------------------------------------------------------------------------
-----oM---o----o??---o--X-?------oX---X---X-------XX-o--X--XBM---o-B-------o-o--M-----X-----X---oXX---------X-------X--X---MM----X-?BX-o---------XB-B?---o---------oX--X------o--------X----------------
-M-----M---------------------X-------o-B----?BM-o-------------B------o----X-------oXM----X------------o-o----M---oo--o-Xo------------------X-o--------?B----o-o--X--------X----o--X--M--B-??---oX-B---?-
-----B-----X-----BBo--X---B--XX--X-------------------------o---M-------X-------X--X--?-----Xo---B--Bo----o-X---B----------?-XX----X--X-B------X------------o---X------M--o-X-------X----------------o---
-Mo---o--X--------o---oo-------?X-----------B------X---------------M-----------X------X--M----Xo--B---XX-----XX---X--E-----B-o------o----------Bo--X------B---------M--------X---M----B------o--o-----?-
-------------o?X-----B--o-?-------XX-Xo--oMX------X--X--X?-XX-----------X---------Moo------M-----X----oX-B---o------oX-B-o--------------------X--M-----oB----o-o---------oo---o--------X-----------o---v
-X-o-X----o-----X-o-Xo-----XM---XX-X-oo-------X-------?----o-M-XX-M----o---X-------------------o--o-X----------XX--X-------------XB-B----------------X-X-X--o----?-X----o---XB----Mo--X-B---B----X--E-Xf
--o-----B---?oo-----X-----X--o----X-------------X----E-MB-o-----------E------X--?--------M---o-X---?--o----o-B---X---o-M-------X--o---------?B------B-----o-Xo?-----oM-o-----------B--B?--XXoBo-XX--BM-f
-----MM--X-----------?-----o--Xo-B-------?X----o---XoM--------X---?-o-X--X----o----B--XM------------o----Xo-----?X------o----X---X------------X-----o----X--------M----oM----X---oX------o-o-----------f
-------------X-----o--M---X-o---o---Xo-------B----o---B---o-----o--o-X-----o------B------------o--MX---o----------------------X---o--?--o--o---X-----o--o------------o---oX---X----B--------?------X-Bof
------Mo-oBX-------------------M---?----o------oXo-X-o-B---X-----------------B-?-X---XXo--oX-o-B----------X?-------T---BX-o-E-----o?----------o--Xo--------o-o--BoX---o------o-------X-o------XXXM-----f
--o-----o-B----o-B-X-B----------XX----o-XBoX--o------o-oX-?----o--o------o-o------B--B-X--B-----M------Boo---o-----|--M-o---M--------------o----oB--X-X-------o---------------o--------XXo-X-X----X-XX-f
m------X-----XX------X------X-----o-----B---------XX-X-XX-----------X---X--XX-Xo--XX-X-XX-X-----------ooX----------X-----------X-X---X---oBX-X-X-------o--XX--X---B-X--------X-----BX--X---X--oX--X--BXX
XXXXXXXXXXXXXXXXXXXXX-XXXXXX-XXXXXXXXXXXXXXX-XXXXXXXXXX-XXXXXXXXXXXXXXXXXXX-XXXX-X-XXXXXXXXXXXX-X-XX-XXXXXXXXXXX-XXXX--XXXXXXXXXXXXXXXXXXXXXXXXXXXXXXXXXXXXXXXXXXXXXXXXXXXXXXXXXXXXXXXXXXXXXXXXXXXXXXXXX
