--------------------------------------------------------------------------------------------------------------------------------------------------------------------------------------------------------
--------------------------------------------------------------------------------------------------------------------------------------------------------------------------------------------------------
--------------------------------------------------------------------------------------------------------------------------------------------------------------------------------------------------------
-M-oX------X--M---------------X-X--XB--X------MX---B---X-X------------------o-o?--------?----------X----o--X-------?-?-oX-----X----?------X-X-----X---X--XX-M-----M--------XM------X---o---Xo-------o---
------------?--------o-------X------------X-?-------?--------o--------X------E---X---X----X---X------------------------------X-o--------o------oX---------X---X--------Xo------?--X-M--o?--o--------o-B-
--------------?--X-----X---X------o-MBX--------o-??-------o?-------X---X-----B?X--B------------X-------o---X---X--------X-------M-B--X--------M------Xo--------o----------M-?--------XX---o-----X-X--X--
------o---B----XX-B---------B-----------------------EX-o-----------------------XX------o-X---M--BM----?---M--------------M---M----Bo---X--?-----o--------B---oo-------oMX----B-X?------X------M-----oX--
-------------M-----o--------o-o--M----?---B---------B-----M------o--MX-----M--M-----------o-------------M---X--------B-----?--?--------BX--M--M-----o--o---o--------------o------o---X?--?-------------v
--B---------------------o?---M-----B-------B-----X----X---------o----X--o-------Xo?-?--------------o-----------X------B--M-----------------------X-------o--oo----X?X---o----o-X--MM---M---------B-----f
-------M------B-----X--o---o---MM-o------------o--------M-----X-----M----------?-----X-XX------?---X-------------Bo-------X--X----------M--?-------o--o---X-----------X-------M-----o---M---o-M-?----o-f
-----------E-X----X-X----o---X---------?-------------------X----------X--B-X-------o-----------------X------o----------M-----o-B------M---------o-?------------------------------?---X---------------oXf
-?-X----XX-XX-BXXX-X-X-----XXX-B?XX--X--XXX--XXoBX-X-XoXBX-XX-X-X-XX-X-X--X---M?M-X--XX--XX----oX?XXX-----X---M-MB--X-------------M----------X----------------------M--M-M-oM--M----X------X-----o--o--f
-----------------o---------oX-----------------------X------------B----o--------------X--o-------------X---o-----------MX----X------X---------B-M?M-------X-------?--------M--------X---------X--X------f
---------?--?--------o-------X-o----X-------------o--------X-o---B-------o--M---MX-o----oX-----------BXo---o--X----------MM------------oMX------------X--------X---X--o-o---X-o--------X---------X-----f
m-----------------X---o--X---o---------X----X-------X-o--------------o-X---------X-X-------X-------------X----o----X---------X------o------Xo--------------------------o----X--X-------B---X---X-XoB-oXX
XXXXXXXXX--XX-XXXXXXXXXXXXXXXXXXXXXXXXXXX-XXXX-XXXXXXXXXXX-XX-X-X-X-XXXXXXXXXXXXXXXXXXXXXXXXXXXXXXXXX-XXXXXXXXXXX-XXXXXXXXXXXXXXXXXXXXXXXXXXXXXXXXXXXXXXXXXXXXXXXXXXXXXXXXXXXXXXXXXXXXXXXXXXXXXXXXXXXXXX
