--------------------------------------------------------------------------------------------------------------------------------------------------------------------------------------------------------
--------------------------------------------------------------------------------------------------------------------------------------------------------------------------------------------------------
--------------------------------------------------------------------------------------------------------------------------------------------------------------------------------------------------------
---o--X-XX----B----?-o----Xo---B--o--X--------E--------?-X-XMM----M------------X---X---Xo----M?-?-o-X---------M-?o---X----------------B-------X----B--o---------o-X------X--------B-B--M-----?----------
--oX---------o----------------X--o--X---o-----X-----------------------?------Bo----B----o-------------X-------------------------ooXB-X------------XB---M?-ooX--B---X-------------X---o--------X---------
---------X--------X--o---------M--B---?--------?---X---X--o------oMX------?-B-----M--?-----------------------oM-o-B-X---------M------------------------------------------X---XB-o--?-----B-XX--M----X-X-
------------M---------------------------?--------o---?--------------?------B----------X---?----X----------------------------------o---o---o--------M-oo-----------o---?-----o-o---------X--X------------
--------?---------?------o-------X----------------B-------BX--o------X?-X-------?-------------o---------------o---------B----XM-------------X--o------o--X--M--o-X-----X--?o---X-?-------B----M-XX-B---v
---X-B-------MX?-----?---X--------o----XX--M------o---------M-------------B------------X--------?--MX----------o--X----------------B---X-----------Xo--B-----B-----M-o-------------o-----------X----B--f
--------?-M-----X--------------o-----------------------o----------XB---B-----o-X---?--M-------------------o--------------X-o---o----o-o-------X------X----o----o--------M----MX--X---X--------X------XXf
-------------XM--------XX--------------------------XX-----o-----X-------X-o------------?------X-------M-------o--o--M------------X-----------X--M-----XX-XX----------o--------o-------------B------X--Xf
---X--XX--B-X--XX----XX-XXX-XXX-X--X--oX-oX?---?X-----X-X--XX-XX-X-X-XX-X-XXM--XXX-X-X------XXBXXX-----XX-XXXX-X-X---X----XXXX------X------oB-o--M----X---------------X--X---o-----------M------B--X---f
----X---------?---------------------MX--oX----------------------o---X--------oX-----M-----?-----X--E--------------------?--------oX-X-----o-X------------?-?-X-X-B-X-------------o-o---o----oX-MX---X--f
-----------X-----B-------X-------------------o-----?-----B--o--o-----M------o---------X-------o----M--X--X---------B-o---------BX-----?-oo---Xo------o-B-------------X-----------o--X-X-----------X--X-f
m---------X------oX-X---------o-----------B-X-------XX--------------------------X------oXXX---Xo----------XX---------------o-B------------X------------XX----------Xo----BX---X-------X--X-------B-o---X
XXXXXXXX-XXXX-XX-XXXXXX-XXXXX-XXXXXX-XXXXXXXXXXXXXXXXXX-X-XXXXXXXXXXXX-XXXXXXXXXXXXXXX-XXXXXXXXXXX-XXXXXX-XX-XXXXXXXXXXXXXXXXXXXXXXXXXXXXXXXXXXXXXXXXXXXXXXXXXXXXXXXXXXXXXXXXXXXXXXXXXXXXXXXXXXXXXXXXXXX
