--------------------------------------------------------------------------------------------------------------------------------------------------------------------------------------------------------
--------------------------------------------------------------------------------------------------------------------------------------------------------------------------------------------------------
--------------------------------------------------------------------------------------------------------------------------------------------------------------------------------------------------------
--------------------------------------------------------------------------------------------------------------------------------------------------------------------------------------------------------
--------------------------------------------------------------------------------------------------------------------------------------------------------------------------------------------------------
--------------------------------------------------------------------------------------------------------------------------------------------------------------------------------------------------------
--------------------------------------------------------------------------------------------------------------------------------------------------------------------------------------------------------
-------------------------------------------------------------------------------------------------------------------------------------------------------------------------------------------------------f
----------------------------------------------------------X--------------------------------X--------------X-----------------------------X--------------------------------------------------------------f
--------------------------X-X-----------------------X--------------------------------X-X---X-----------X------------X-------------------------------------X--------------------------------------------f
---------X--X-------------------X------X---------------X-X----X------------------X-----------------------XX------X------XX----X------X-----X----X-------X----------------X-----------------------X-----f
--------------------X-------X------X-X--X------------X-XX--------XX------X--XX----X----------------X-----X-X------X--------------------X--------X---------X---------X-X---X-X-------X-------XX-----X---f
mX-X--X-------XX--------X---XX---X-X---X---X--X-------X---X-XX-X-----X-X--X--XX------XXX-X-XX-XX-XX-------X---------X--X-----X--X-X--XXX---X-XX--X-----X-----X-X-------X-XX---X----------X-----------X-X
X----XX-X--XX---X-X-X----------X-------X--X---------X--X-X--X----X----XX---X-XX---X-X-X-XX-XX--X----XX-XXX----X---X---X-XXXXX---XX-----X---XX--X-X-XX----X-----X--XX-----X-------X--XX-X-X---X---XXX-XXX
--------------------------X--------X-----------------------------X-------X-------------------------X-----------X----X-----------------------X-----------X-----X---------------------------X------X-----v
-------------------------------------------------------------------------------------------------------------------------------------------------------------------------------------------------------f
