--------------------------------------------------------------------------------------------------------------------------------------------------------------------------------------------------------
--------------------------------------------------------------------------------------------------------------------------------------------------------------------------------------------------------
--------------------------------------------------------------------------------------------------------------------------------------------------------------------------------------------------------
------------oM------X---------o-MX-------o-?X--------------X--------X--B-X--?--X------o?------------?---------------------X----X------M---X-XX-o-B------oM-------------------------------?------X--MoX--
----o-?-X------o--X?----------X---o----------X------MX-----XM----------------------o-M----------M---------X------?M----o-X---------------?----o-?X----M----------------X-o---------B------M-X?-M------X-
--X--------XM---EX---?-------o-?M?-------XM---X------oB-------X-Boo---oX------o--------?--M---M-----M--B--o--------?--o------X?--o---X-?---?B------------B------XX-X-M---------?M--o--------------XB----
-----?--------BXX-----oX--Mo---------M-----X-------M---MB----------------X-XXX-X-B--Bo--X---X---X-------------X--X---o-?X---X-----E---------------MX--X-------X-B-B------------------B-----X----------M-
--M-----------o--o--X-------?-----B-----?----B--------------?-o-----Xo-X--------X--o----------X?--B-----oX-o----M---o----o?------oMM-B-BBX-----o---B-----?-?-----------X----------o------o---o---------v
---MM--XB----------?---------------X-------o---o-----------------o-o-----------------------M-----B-----M-X-----------?--o--o----------oo---Mo-o-------o--------M-----oo----X--o-X?----X-----X--------X-f
--E------B-X--------o----?-?----------o-o-----M-o---??--?B----------X-M-?X---XX-Bo------?-----------X--------M-----X---M---o--?---B-----?---X-oo-------X-X-X-------o---------------------------B---?---f
--?----------o----oMX----------------o---------o------------XX--o--------X----------------o---X----------M?---?-o----X----o----X-------------------------X--X---------B-----M-----------Xo-X----?----o-f
---?XXX-X--B-o-XM---------------------------?o---------o?-o-oB-B-----------??--o------Xo------X-Mo---o----------------o---X-M-MX----M-----XX?M--o---X----------o---B-----M----Xo----------EX-oX--o-B--of
-------o----------oB-X-Xo--B----X---X-----B-----?--------------oo---o----------------Bo---o-----------B----B-XB--X?o------------------o--------XoXX----o--Xo-T------XX----------Bo---o----X----?--o----f
-----------X-o-----o-o------B-B--X---X-------oo-------M----M---------X---X----------X-----X--------X----BM----------Bo--B------------X--B----o---B--o-B------|----oB------ooXXXBBX-o--o---B-oX--X------f
m-------Xo-X--B----------------X--------B-----X-X--o--------------X----------------X------------X----------o---------X--X-B------o----o---------------------oX----XX-----X-X--oX-X--X-o-X-X--X-oXoX---BX
XXXXXX-XXXXXXXXXXX-XXXXXXXXXXXXXXXXXX-XXXXXXXXXXXXXXXX-XXXXXXXXXXX-XXXXXXXXXX-XXXXX-XXXX-XXXXXX-XXXXXXXXXXXXXXXXXXXXXXXXXXXXXXX-XXXXXXXXXXXXXXXXXXXXXXXXXXXXXXXXXXXXXXXXXXXXXXXXXXXXXXXXXXXXXXXXXXXXXXXX
