--------------------------------------------------------------------------------------------------------------------------------------------------------------------------------------------------------
--------------------------------------------------------------------------------------------------------------------------------------------------------------------------------------------------------
--------------------------------------------------------------------------------------------------------------------------------------------------------------------------------------------------------
--------------------------------------------------------------------------------------------------------------------------------------------------------------------------------------------------------
--------------------------------------------------------------------------------------------------------------------------------------------------------------------------------------------------------
--------------------------------------------------------------------------------------------------------------------------------------------------------------------------------------------------------
-------------------------------------------------------------------------------------------------------------------------------------------------------------------------------------------------------f
--------------------------------------------------------------------------------------------------------------------------------------------------------------------------------------------------------
----------------------------X--------------------------------X-----------------------------------------------------------------------X--------------------------------X-----X--------------------------f
-X---------X---------------------------X--X------------X-------------------------------------------------XX---------------X--X--X-X--X-----X-------------------------------------------X---------------f
-------XX-X---------X----X--X------X----X------------X-X------X--XX---------XX----X------X------X--X-----XX------------X---------------X--------X----------------X----X---X-X----------X----XX-----X---f
mX-X--X-------XX--------X---XX---XXXX--XX----XX--X----XXX-X-XX-X-----X-XXXX--XX------XXX-X-XX-XX----------X----X--X-X--------X----X-X-X----X-XX--X-----X-X-----X-----X-XXXX---X-------------X--X-----X-X
X-X--XX----XX---X-X-X-----XX--XXX------X--X-----X-XXX--X----X----XXX---X--X--XX-----X-X-XXX-X--------X-XXX-X--X---X---X-XXXXX---XX-X---X---X-X-X-X-XX----------X--XXX----X-XX-------XX-------XX--XXX-XXX
--------X--------------------------X-----------------------------X-----X---------------------------X-----------X----X-----------------------X-----------X-----X-------X-------------------X------X-----v
-----------------------------------------------------------------------X-------------------------------------------------------------------------------------------------------X-----------------------f
-------------------------------------------------------------------------------------------------------------------------------------------------------------------------------------------------------f
