--------------------------------------------------------------------------------------------------------------------------------------------------------------------------------------------------------
--------------------------------------------------------------------------------------------------------------------------------------------------------------------------------------------------------
--------------------------------------------------------------------------------------------------------------------------------------------------------------------------------------------------------
--XX----------------M----X---X------X----oX-?---X---X--------------o-------------------M-M-----------X--X-M----o---M-----------X--------B--?---B--------------------------------------------o-----------
-M-------X--X-X-------X--X?--o------o-----X-----------------o---o---M-----------XM---------------------------X---X------------XX-??--------------X-XX---X-------?---oX--?X---?B-X---------?-X--M-o----X-
----B--M-------------------B-----XX------X--M-----M---o----X--B--M---BB------o-----------------X---X----------M----M-X-X----X-----------M--------------oX-X---X--X--o-----X----X--?---?-------------o---
----------o-M---o-M---------X?------B---oX------B---------------------BB---------X-o--------M----X--oM-----?----X------o-----------X--------------------------X--------------------o---oo------?o-------
------M-----------------------XX-----MX--------------M---X---M-o-?--X-----------------o------------o---MB-----X--X-M----o----X---M---------Bo--oo-------?------X--------o-----------X-----------X-X----v
-X------X----------X--?---------X------?-B----XM-X-----MX------X------X?-oX-----o------------------------Xoo--------------M----------o------------oX-----?----X--X--o-X----------X-------XMoX----B-----f
--------X--------------X-B-----------------oo-----X---------o------??-----------------------------o---------------------M------B-?--?--M----?-M---X---Bo--o-----BXX-------oX-------B--------------o-o--f
-----M------?M-------o--X-----o-----------M----------M------o----------B-X-X---------X------------------------------Mo------X-------------------?-------------o-----X---Xo---??--BX--o----o------------f
---o------o-----------X--------------------oB----o---------M-X-----B-------------M---o----X-----BX-B------M----X----------M-----B-----------X---------B--o------X---X--X-------?-------o-M---o---X--B--f
-X----X--------------?-X--M?---M-----B--X---X--X--M--M--XM------B-----?B--X-B---------o--------o-------BX--o---o---oXMX-?--------MX--B----------Bo------o---X?---------BT----X--------Xo--B--XX--B-----f
--------B-------X-----------X-----o--o--o------o------o------------o-----------------------M----------------------X-------o--XX----------MX----------X-o------o-X----M--|-o-----X-X-B---------o-B--o-XBf
m---XoX----o--------XX----X--B-------------o-oX-------X-----XXX---X-B---X-------------------------------------------XX-X-----X----XX---------X----X------XX---X--------oX-oXX----------X----o---X-B---XX
XXXXXXXX-XXXXXXX-X-XXXXXXXXXXXXXXXXX-XXX-XXXXXXXXXXXXXXXXXXXXXXXXXXXXX-XXXXXXXX--XX-X-XXXXXXXX-XXXXXXXXXXXXXXX-XXXX-XXXXXXXXXXXXXXXXXXXXXXXXXXXXXXXXXXXXXXXXXXXXXXXXXXXXXXXXXXXXXXXXXXXXXXXXXXXXXXXXXXXX
