--------------------------------------------------------------------------------------------------------------------------------------------------------------------------------------------------------
--------------------------------------------------------------------------------------------------------------------------------------------------------------------------------------------------------
--------------------------------------------------------------------------------------------------------------------------------------------------------------------------------------------------------
---------B---o-----------------------------------M?---------------------M-------------------------------M-----------------X--------------------X--------------X-----------------------------------------
---------M-------------X-------------------------M---oX--------------------------?------?o-------X-?--?--------o--o--B------------XM--o--------X---X--------------E-X---------?----------------o-o------
----X--------X-----X-?-------?----X?--------?-X------M--------?-M--------?-?-----------------?--------------Bo-------------o----------X------------------X---------X-M?-B-------------X-----------------
--------?------------X-------X------M---------------------------------------o---B-------?------------------------?X--------MX-----?----?-o?---X------------?-----------------------o-X------M-----------
--------------------------------M--------M---M-----X-----------------X------------o---------M-------------------------B-----------------?----------------------------X------------B--------------------v
--?--------------------------------------?--------------?------------------X--------?---------------o---------XX-----M---------------------?--------B------------X--------------M--B---?-----?---------f
---X-------M------X---------M----o------B--X--------------?-----o-----------------------?-----M------------?---------------------------X----------o?---------------M------------X----------------X-X---f
-o------o----------------------------------------X---------------------X---X-o-o-------------------M---o--------------?---------X--------M-o--------o------M----M------------BX-----------------M--o-o-f
--------------X---XX---Bo--XX-X-------X--------X------X-----XXX-X------X--------M-------------------------XX-----------X--------------------------X----------X-----------M---------B----------------X?-f
------------oo--------------------------X---------M---------------------------T---------------M---X-----------------------------------------M--------------M-M---------M-----X---------?---------------f
-------X------X-----XM----------?---------------------M-X--------X------------------------------------o-----E-------------B---------B------o---------X--------M-M-?--------BB-------------o----X---|---f
m----------------------------------------------------------------------------------------------------------------------------X-B----------------------------oo----------o---X-----------X-B---X----X---X
XXXXXXX-XXXXX-XXXX-X-XXXXXXXXXXXX-XXXXXXXXXX-XXX-XXXXXXXXX-XXXXXX--XXXX-XXXXXXXXXXXXXXXXXXXXXXXX-XX-XXX-XXXXXX-XXXXXXXXX-X-XXX--XXXXXXXXXXXXXXXXXXXXXXXXXXXXXXXXXXXXXXXXXXXXXXXXXXXXXXXXXXXXXXXXXXXXXXXX
