--------------------------------------------------------------------------------------------------------------------------------------------------------------------------------------------------------
--------------------------------------------------------------------------------------------------------------------------------------------------------------------------------------------------------
--------------------------------------------------------------------------------------------------------------------------------------------------------------------------------------------------------
--XX----B---------X-------o?X----------o-----------o----o------M---X--------?---X--X-----------??o---------M------?-------X----------X?---B-----M--X----X---B----M----o----------------o------X---------
---------X?-o--M------XX----X----o---o-----X?-----XB--------EX---------X-----X-o-M---------o--------oo--X------------o--oM-----------------?--M--M-------------o------------?--X----XB--X-X--o--X-------
-o------X-------------------------B--------------------o---XX-----M-----------X------------------X---------------X-BB-----------X-XME---M----------M---o----X-oX------------EX--o----------X--Xo---o----
--------------XX--MX-o------XX---B-?-----------------X-B-------------------M---o----X---o--------------X--------Mo-----------o------X-----o-X---M-----MX----------o-----X---X-o-----?-M--X--------?-----
---o--oX---B---------XM----o--X------X------M-M--------------M---X-X-------------?--------oX---------X?-----B------------XB------------X-----M----M-----M------o---------X-o-----------------B-?-------v
-XXX----------X--M--o----------?-------X--M----o-o-----?----------X---o--o-o--MX-----BB-o--Bo---X-------X------------X--?--o------------?-------X--M-------X-----XoX----X-----------MM---M-Xo----X-?--Xf
---------o---o-----X-----X-M----MX-----------X-----------------o-X-------------X--------X-X---?-----------o-o---M-------------------X----X------------XXB--B---o--------X------M-------o--o-B--X----X--f
----X--X---oo-----o---B-------------X-----------Xo--X-----X--------X-------B-o------o--o----o---o--X---------------------------X-----o--B-------XX--X----B--MM---X?o---X-----X---o-?-----X-------X----Xf
-X-X--X-X--X---X---Xo---XXXXXX------X-o--XoXM?--o-oXXXX--X-XoXX-XXX-oX--XX-X-XX--MX---XX--M-----X-M-BX-XX-X--XX--XX----XX--X--X-M-o-MX---X---X-?---------------------o---X-------------------X------X--f
-----X----------------B-----X--X------------------X------------M---X----------------X------B------------o---o--?---TXB----BBo----oX---X----XM-------X--X---oMo-------------o-----o--?oX---X---X------M-f
----?-----?---B------?-X---?-X--X---X-X-M----o-M-X----B------o---------------------M----o----------oM-----oM----X--|-X----o-B--B------o---B-----oX--B-----------------B----oM-?M-----BX---o?--B---X----f
m-----X---------------BX-------o---------BX---------B------------------X-------------------------X---X-X-----X--X--X----X------------B---X------o--------------X-----X-X--------------X-----oX-Xo-B-X-XX
XXXXXXXXXXXXXXXXXXXXXXXXX--XXXXXXXXXXXXXXXXXXXXXXXXXXXXXXX-XXXXXXXXXXXXXX-XXXXXXXXXXXXX--XXXXXXXXXXXXXXXXXXXXXXXXXXXXXXXXXXXXXX-XXXXXXXXXXXXXXXXXXXXXXXXXXXXXXXXXXXXXXXXXXXXXXXXXXXXXXXXXXXXXXXXXXXXXXXX
