--------------------------------------------------------------------------------------------------------------------------------------------------------------------------------------------------------
--------------------------------------------------------------------------------------------------------------------------------------------------------------------------------------------------------
--------------------------------------------------------------------------------------------------------------------------------------------------------------------------------------------------------
--------XX-X--B----?X------X-?---------X--o-----------M---?---X-M-----------X----?-o-M-o--------M---o--------------XX------X-o-?--------?---X-----------B-o--X-X-----------X-----------M--------MX------
----------o----------?X-------?-X---X-------o-----?-----------------XX---------M-----------?--?---M----------M---X-X------o--------------X---o----o------o--M-X----X--X-X---------MM-------oXXM---------
-XX---o--X-?-------?---MM---X----------X--X----------?---XB---------X-------X---o-----------X-----------BXBM---X-----X-MX-----o-X-B-----o------------X----X----B-?--------o-?-BXX---X----B-o---M?M-B-o--
-----X---B---------------o------X----o----X-------M---o-B--o--------------------------------o-o-X---X?o--X-------o-X--------B?----B----------o-B-----o---MX---X---------M----X---M?----o-----------o?---
-----------XX----?--BX-M------B----XX--Xo-----------B-------------oM---------o-------o-M--B--------------------?------BXM-----------X-----------?---?--------X-----XX-------X-----------?X----o--X-----v
---X---------X-----o-------------?--------------?----------X--o----------------MM--X----MX--X---------X-----------X------?---?--o-----B------XX------oo--o---------------MX----X------------X--X---o---f
---------M--------------X----o?------X-M---?--X-----B-o---------B------X-?--o---------B----X-------o------?----------?B-------------XX--X?------B---------M-----oM---B-o------------?X----M--------o---f
--------------------X-------------------------------------M----X----------X----X---------------------B-----------------X---------E-X------?M-------X-----------------Xo----?---------X--------?-------?f
----X-X--oX----oX-X--XMXX-X-XX-X--Xo--X-----X--X?X-XX--X?----XM-XX-X-XXXX--X--X---XXX-X-X-XXXBXX-XMo---XX--X-X-XX--o---XXM-XXXoo-B----M-----X----XX--------M---o------------o-X?-B-o------X---------o--f
--Xo----X---o----------X-------o-oX-----o-----X-----------M-------o-------X-----B-----o----X--------X-------T---------M--------XX---o--o--Xo-?---o---o-o---------------M--M-----------X-----X--X-----B-f
------BX---------o-------o-------------B-o-M---X?--?----o--B-oM-?---------X--X-?-M------?-?------X--------X-|------M-----B---o----X-----MX---------o----o------B-o---X-------X----Bo?-B------X--o--o---f
m------------X------o---o----X--X-------------------B-------X-------Xo---X---X-------X-----XB--X---X---X---oXX-X-----------------o--------------o----X-X----X---X-o----------X-X-X----B---oX-X-XX---ooBX
XXXXXXXXXXXXXXXXXXX-XXXXX-X-XXXXXXXXXXXXXXXXX-XXXXXXXXXX-XXXXXXXXX-X-XX-X-XXXXXXXXXXXXXXXXXXXXXX-XXXXXXX-XXXXX-XXXXXXXXXXXXXX-XXXXXXXXXXXXXXXXXXXXXXXXXXXXXXXXXXXXXXXXXXXXXXXXXXXXXXXXXXXXXXXXXXXXXXXXXX
