--------------------------------------------------------------------------------------------------------------------------------------------------------------------------------------------------------
--------------------------------------------------------------------------------------------------------------------------------------------------------------------------------------------------------
--------------------------------------------------------------------------------------------------------------------------------------------------------------------------------------------------------
---X-oo--------B----------------o--B------------X---------?--X-----o-----?------X--X-o--o--X--------M--XB----?-------B-------------B------o--X------X-----o---------------o--XX--o-------B--------------
---------?-X--o--X----?-----------------------B-----------------------X---------------------?-----?---M--------------B------X----X-----------o-----------------o-----X-M--------o-X-X--oM-------X-------
------XM-----Xoo---------?-?--------------?--M--XX--M?-o--------?------X-X-o----B---------X--------------M----------X----M--EX----B--o----X-----X--X-o-oX-----o---B--------------B---------?--o---XM----
--------------------XB-------X--------M-----------------B--X?------X--------o-X-------?o--X---------XBB------M-------M-X--X-?---X----------?----B-?o-------B-X-----------B-?----------o?----X-----------
--------?----------M--B-----X--X------------oX----XX-X-M-----X---------M---XX------X--------Xo---------X-----------------------X-X-----X------?-----?--?--?---o-M---M-----------------------X-----X-M--v
-------------?-o----M--------?--M-----B-------M---------------?M-----------------o-B------B-------------------o---o---------X-------X-o--M-o----o-----------X--------X-----XB-----o--B-------X-?--o----f
------M-------X--B---?----o---------------oXo---?-------oX--X---M-------------------o-------------------M-X--X------------o---------o--------oE--X--Xo-----o-M---X---o------X-XB-X-X---?Xo------B------f
---o---?-------?--oo----------?--------?----------------o-o-B----B--X?-----X------o?------o----?-X--------------o-?----B-M-----o---X---o------B-----------?------------X------------XX----M-?----o-----f
-------------o--------M----X----?---------XX------o-------------?--X----------M-----------------------B-------M-----X-----oXo-X-----MX----B------X-----B------X-----XB------M-----BX---MX--------o-----f
------o----------------?X-X--------o----------X-o----------o----------M-B-Xo----------o------B----M--------B-------X----o------------------M-----o------X----------X--------------------X-?-X-Xo----X--f
---------------------B----o--?------M-------EB-------------X-----X--B---------?-----------------------Xo---o--X------X---------------?X--B--X---------------X---B-o--X------oo---------X---o---X----B--f
m-X-------o---X------------B----oX-------o--X-o----B--------------------X-------B----X-X--X-o---X-------------o------------X-------o--B-X-----------o-----------oB--X----X-----oX----oX----X---X---B--XX
XX-XX-XXXXXXXXXXX-XXXXXX-X-XXXXXXX-XXX-XXX-XXXXXXXXXXXX-XX-XXXXXXXXXXX-XXXXXXX-XXXXXXX-XXXXXXXXXXXXX-XXXXXXXX-XXXXXXXXX-XXXXXXX-XXXXXXXXXXXXXXXXXXXXXXXXXXXXXXXXXXXXXXXXXXXXXXXXXXXXXXXXXXXXXXXXXXXXXXXX
