--------------------------------------------------------------------------------------------------------------------------------------------------------------------------------------------------------
--------------------------------------------------------------------------------------------------------------------------------------------------------------------------------------------------------
--------------------------------------------------------------------------------------------------------------------------------------------------------------------------------------------------------
--------?o-?--------?--o--M-?--------------------MM-o-X---------?-o----ooX-X---o--------XX-----M--------M-----M--XB-o-M--o---------X--BM---M--------o-----------------oXMM--B--oX-X-X--X-XX-----o-X--X--
-X----------M?o-BoX-----X----------X-B--------Xo----B---o---------o---------X-oo-------B--o--X----B-X-o---X-----o-B-----------o-----B---M---------------o-B--o-------M--------M-X----o---------o--------
-----X----X-------X----?--------B?-X----X--o-B-----------X----X----X-----X----X----X----X------o-M-X----B-----oM---M---?-X---------B--B-------o-X--X-XX--X---oBX------oXMX-B---?-----X-X-----X-o------M-
---B-----X-o----------------o--X----X-------?---BX-o-------X--BX-------?----M--Xo-?-M------X---X------B--------------X--X-o----X---------XBB--------B-----M---X--B--------------XX--X---o--o------------
--o-B--X----X------o----M--X-X-----X--X-------X-------X---------------------------------------X------?--M-oM----------X--M--o-------------B-o-----------X------------M----o-M-XX-------X-XX------------v
-M---X-----X---??---o-?-------------?------Xo---X-------X--?--B-X-?-o--------M------------X-----o-------------XX--X-X------o-X---?X-----------X-MMo---?----------?M-----X?B-----?-X-X--X-----?---X-X--Xf
----Bo---------------------B-----------X-o-o----X--o-o------XX-------X--o--X---------------M-----------X---------M---o---X---o-----X----X----o---------X-----------Bo--X-----o--------o----X---X---X-B-f
-------o----M--------o-M---B----------o-M----oMX-------B--X--o?----------Xo-XB--o-------X---------o--o---------X---B---X------------------B---B-------X--------o-----X---XXo--X-----------------X------f
--------------XBo---o-----------------------o---X---------------X----------X-----M---o-o----o-----o--X---M-X---------M--X--o-M---M-M-----o----X?---X---o-oo---M---BX---M--B-----M---M?-oXX-?X-----B---Xf
--o--oX-X----------------X-?-XXX--------?-----o-X-B------X-------E-XM-X-M-X--oX-----o-?--X---E-B---o------M-----X--o------M----X----------E--------X-M--X---X-----------------M--B------X---X---------Xf
-----X---o-------------------o-o----------------------?-Bo---B---X-------------?----------X--M------B--X-------X--X-----------?X----o-MX--B-?---------Xo---B--------M----------o---M-X-o-----X-X-----X-f
m------X--X-----oo-----B-----------------XB-XX-------------------------------------B-B-B---------X-----------------o--B----------X-X---------XX--------o------XX-oB-----B-o----o-X----oX--X---oXo------X
XXXXXX-XXXXXXXXXXXXX-XXX--XXX-XXX-XX-XXX-XXXXXXXXXXXXXXXXX-XXXXXXXXXXXXXXXXXXXXXXXXXXXXXXXXXXXXXXXXXXXX-XXXXXXXXXXXXXXXXX--XXXXXXXXXXXXXXXXXXXXXXXXXXXXXXXXXXXXXXXXXXXXXXXXXXXXXXXXXXXXXXXXXXXXXXXXXXXXX
