--------------------------------------------------------------------------------------------------------------------------------------------------------------------------------------------------------
--------------------------------------------------------------------------------------------------------------------------------------------------------------------------------------------------------
--------------------------------------------------------------------------------------------------------------------------------------------------------------------------------------------------------
----B-X-----B--M------oX---?-M?----------X-------o---------E-X--o----X-X------o-------X---------------M------------BM?---X-Xo---o?--------X------Xo---o-BBM--B------M--X----B---M-?-------X-o-----------
-M?-----X?------------B-?-------B-----------------X-o-M----XB-----------X----XE-----------o----BX-M-----?-----X---------------?---------------o-X-o-X-------o--------o---B----M-----B-----BX------o?----
----------X----X-?X---------------------X--M----o-------X--------------------oM---X---X-------o-------X-------------X----X-----BX-X-----M-o---X----------X-----o------------------MM-X?-X---o??-X----o--
------Bo-o----------X?oB-------MX--X--------BMX---X---X-----X------oo--o-----------o--------o----------------Xo----o-------X--------o----?--MX-Xo--oo---------------oM----X---------M------E-----M------
-?------------o-M---------------------?--o----X?o-----o-------------------------M---B--------?----------o-M--------------o--?----B--------------E---oX---------XBo----------o--------------B--X---o-o--v
---M------X-oo-----------B--------?-----o-------B---------?--X-----M--X--?--------M----B--------------BM----X-B---M-B----------------X----------Xo-------o---------Xo-XXX----X--B--o--oM---X-----------f
--------------M-----M----Xo-X------------X-Xo----XX-----------?--?----B-------?----?-----X--M-----------MM------X----MB--B----o--M-M--?----------------X-X--------X-o--Xo-----X---X-----X------X--oo---f
-X---B-----------------B-----------------------X---?-------?-------B-------------------------------M-?------------o------------o----------X-X-?-----X----------X--o?-------o-------X--?-----M-------XX-f
--X---X----o--M------X-------------X-----------------X---------?oX-X-?---X----------o-o-X---o----X------M---X-----------------------------------X-------o-M------M------?----------------------X-X-----f
-----?---X----------X-----------------XM------o-?oB-------------------X------o-X----------MX-----o-----------o------o------------o-----M--X--?T---o-----X-----------o-------o-?-----X-------XXoB-------f
-------M--X------o----M-----o----o--M------X-o-----oo-----X--------?-------B-Bo--?o-M--------BX---X-X---------B-----X-------------------------|B--X--------------B----?-Moo-----B--o--------X----o---X-f
m-----------------------X-----X-X--------------------o-------X-X---------------o---------XBX--X-------------XX-----X----------X---------------X--o-X---oo--o-----------------------X----B---X---XX--oX-X
XXXXXXXXXXXXXXXXXXXXXXXXXXXXXXX-XXX-XX-X-XXXXXXXXXXXXXXXXXXXXXX-XXXXXXXXXXXXX-XXXXXXXX-XXXXXXXXXXXXXXX-X-XXXXXXXXX-XXXXX-XX-XXXXXXXXXXXXXXXXXXXXXXXXXXXXXXXXXXXXXXXXXXXXXXXXXXXXXXXXXXXXXXXXXXXXXXXXXXXX
