--------------------------------------------------------------------------------------------------------------------------------------------------------------------------------------------------------
--------------------------------------------------------------------------------------------------------------------------------------------------------------------------------------------------------
--------------------------------------------------------------------------------------------------------------------------------------------------------------------------------------------------------
----B--X----MX-------X---X----------o--o---------X---oX------B-----o---XX-----?-Mo--?--------X---o--------X--------X-----X-----B-B-----------------X-oo-BM--o-M----X-----------o----------B-o-M-----?---
-------XMX----?--??----M-----o----BX------?--X-----------------X-X-------M-?X--------?---------X----X----------------------Bo----------------X---Mo-M--M--X----X--o---o--X---------M-----------X--------
--------------------------X-----------o--------------o---oB---B---BB---B------X---------B--X-o-------o--------X-BX-----------X--X--MX-X-X------------o------XoX---------B---X-B---------XM--oM----X-----
--------------X-----M-----------X---B---?-X-----o------------------B------------?-----------------------------X----M---MXB-----------o----BoM---o---B-----------------X?------X------XB---------o--o--X-
-----o--------------------X-o-----X---o-------------X--M-B-------?---------o-X----------X-E--------o---------X------------------o-X----o---------o--X-XXX--------X---B---Xo----------------?X----------v
---o-----?-------------------o--M----------o-----o----------------B--X---M--------------E-M----------------X----------------E-------X------o-o-------B--o----M--o---BB--M----X------X-o-o--------M---o-f
----------o----X-Xo---------------M--------o---BB----X---------------X-?---M-----o-B----?-----B--o----o----X-XX-------oMo-X-XB----BoX-?B-o-----o----X-BX--X---------o-----o--B--?---------M-------oo--Bf
--------------------Mo-B------M------?------X--Xo------------?-----X---------?-------o---------X--o------B------o-------o---o-----B--------X--------X--X----------------BB--o-o------?-XX-----------B--f
-----X-----Xo----XM----------------------o----------------X---------------------------o---------------M-X----o-----?---------M--B---------?-----o-------M-XX------??--------X-----XX-------X---X---X---f
---XM--?--------X--X--------B-----?--?-BM-------------X--B--------X--o------X------o?-------X----?-----------BB-----------X-------o-B-----------------------o--------o-X---X--X----B---B-X---o--BB-----f
-------------?-B-------------------------MX--X-o--M-?---X---------X--o--X-----o-------------X----------?------------o---XX-----o--------o-----MX-M---o----------BM-B---X-X-o----X-?---?---X?-----Xo----f
mX------------X--oX-------o-----------------B---------X--X---------X--XX--X---X-------X----B--X----------------X--o---------------X-------X--------XB-X---X--oo-----X-oX----X--X---Xo---o---B-X-B---X-oX
XX--XXXXXXXXXXXXXXXXXXXXXXXXXXXXXXXXXXXXXX-XXXX-XXXX-XXXXXXX--XXXXXXXXXXXXXXXXXX-XXXXXXX-XXXXXXXX-XX-XXXXX-XX-XXXXXXXXXXXXXXXXXXXXXXXXXXXXXXXXXXXXXXXXXXXXXXXXXXXXXXXXXXXXXXXXXXXXXXXXXXXXXXXXXXXXXXXXXX
