--------------------------------------------------------------------------------------------------------------------------------------------------------------------------------------------------------
--------------------------------------------------------------------------------------------------------------------------------------------------------------------------------------------------------
--------------------------------------------------------------------------------------------------------------------------------------------------------------------------------------------------------
-----------------X-----o---------?-----X---Xo-X--Mo---------------o--XXo--?X---o--o------XB-------o-------o-----M-B-----oo-o-----M----X-------------X-------M?-----?-?------B--o----X---o-M-X---X-B-?---
--M---------?o-o-----MX--------X---o----X-----------BBX---B-----------------X----------BXX-X-X--------------X-X---X-----B----------------B------E--?----X-------B---------------?-B----B------B---------
-----X--E-X----o-------o--o---X--?----?-XM----M----o----M--M-------X--o--Xo---X---X-------oXX-------------X----M---M---X------XX---X--B----X--B-X------------?--------oX------X----M--o------X-M-o--?-?-
----?---XXX--XX---X-----?--Bo-------X-------X-----------------o--------?MooX-B-X---??-----------------B-X----?--------X---X-?---X----o------X----X---o----------X--------------oXX---------X------------
-?----X-----X---o--------?-X-------X----o-M------?--X----------X-------------X--M-------M-o---X-XB--X-----------X----o--------o---------------M----X-X--X----X---o---XB---o------------M-M-o----------Xv
---o---?---XX------B----------M--M---------?--X---BX-B----------X--M----?-?---X------------BX-----X---?-----oXX--oX--B-------X-----X---o-oo-----M-o-M----?M---M-----M----------X--X-------X-M-------X-Xf
---------X---------------X-----X--X--M-X-o-----X---o-o?-----o-X------------X-------------------------------------------M---o--MX--------X--------------o----------o----X-----o-------?--?-X--X-M-------f
--M--o--------------M-----------------oX-----o?X--?-X----B---o-o----o-o---o----X------------X---oX---o---o?---o-----------------X-----X---------------o-------XB-----X-----o--M-----------------X---Xo-f
---------X--X-X-oX---------o--B-X-----o-o---o--------Xo---------o-o-----M--X-------XB--o--Xo----o-----o-X---M----------------M-X---M----------X--X-X-X-o-o------------o?-----------B-------o-X-----B---f
-o?--------?-o-----o-o----X---X------?-----o----X-X------------o---X----------X--------X-----------o---B--o------M------o-------------o----X-------------XMo----o--B-X---o--o------------o--------B-?-Xf
------------X------X-------?-X-X-------B-------oX--X--?-BX--------X--oo---M----o-X--------?----X---------------X------Bo-----MX--o--o--------X---X--X---------------?---M------o---M-X-----X---X-----X-f
m--X------X----------------------o------X-o--X--X----------X-X--B-----o--------X--X--o---------X----------o---X-----X-----X-----------oX---------------o-X---Xo-------X--oo-o--------X--X-XX--oXo--oX--X
XXXXXXX--X-XXXXXX--X-XXXXXX-XXXXXXXXXX-XXXXXXXXXXXXXXXXXXXXXXXXXX-XXXXXXXXX-XXXXX-XXXX-XXXXXXXXXXXXXXXXXXXXXXXXXXXXXXXXXX-XXXXXXXXXXXXXXXXXXXXXXXXXXXXXXXXXXXXXXXXXXXXXXXXXXXXXXXXXXXXXXXXXXXXXXXXXXXXXX
