--------------------------------------------------------------------------------------------------------------------------------------------------------------------------------------------------------
--------------------------------------------------------------------------------------------------------------------------------------------------------------------------------------------------------
--------------------------------------------------------------------------------------------------------------------------------------------------------------------------------------------------------
--M-o?--M--------------o---------o-------------XX-------X--o??-B-o-o--oo----------X-B-----B---------------o---B-X?------X--X----------BMo------B-X----------X--------B---M-Boo---X---o------X?---?------
------o------X----------oM-------------------oXB---XM-?B-----------XB---------o-----o----o--X----?-o---B-?----X---?----X----X---X--------X---X-X-----X------XM------?-----XXXo--?-o----B--B-------------
--------?-X------X?---X----XXX---o-------X-?------X-------o------o----M--XX----X---o----B--o-MX-------X-----o----------X--?----X-XX-----------o----------XM-----X-----Xo-------------o-------o-o----o---
-M-o-----------o?---M------X----o-B------------M---Boo?-------o--------------M-X----X--X----------X---B-----X--------?-------XM---------X-------o------BB------X-----X--------Boo---o--------------X----
---o--o----XX-----o--B?oM-----X--B-o--------Xo---------X-------o----o--?------o--X------------XBX-------o-------------X----------X-MM-------M---------------MM---o-?------oo-X---M------XMXoM----X-----v
----?------o---Xo---------------------o--X-B-B--------X--o---BB-X-M-----------oBX------------?---oXoXB--o----o---XB--B--M--X--MM----------o---M----------------B------ooM------X--------------?-Bo-----f
-X----XM-----X-------------o---X---------X--------------------o--------X---------X-oBX----------------XX------o-----M------o----o--------BB-------o---------Mo-o----------B--M--B-------------------M--f
-o---M---M--M-------B--X-o----X-------M-o--------o---X-B--------?X-------------X-----X----M--o?---M---Bo--XX------o------X-----?--M----------o?-----o---X-----------MB-----------M-oX----M---o--X?M--o-f
----------------XXE----o--X--------------?--o---------------------X-XBM--B----o---o-X----------------------------------o------------M----o-X---X---X----E-----MM--B-----M-X--XMo-----------X----------Bf
-o-X--------------XX----B--X----X-M----o--o---X------X-----T---o--XMo--?M------------B--XXM----XX--------X-B-MX---------X--BB-----?----------------o--X-X---o---o-----o--B-----Xo---B-T--X---oX--B-----f
----M-o-M---Xo--o---oM---------o------------X--X---M-o-----|--------------?----X--------X---?-------EX---------M------?-----XXX-------o----o----oX----B--o-o--X---BoM---MB---o--X-----|---X----X--?-XX-f
m-----X--------X------------------X--oX--o--X----X---------X------X-------------o-X-oB-B-X---------XX-------o------X----------------BB----X------XB------B-----X-o-----------o-X----o-X-o-X-BXoX----X--X
X-XXX-XXXX-XXXXXXXXXXXXXXX-XXXXXXXXXXXX-XXXXXXXXXX-XXXXXXXXXXXXXXXXXX-XXXXXXXXX-X-XXXXXXXXXXXXXXXX-XXX-XXX-XXXX-XXXXXXXXXXXXXX-XXXXXXXXXXXXXXXXXXXXXXXXXXXXXXXXXXXXXXXXXXXXXXXXXXXXXXXXXXXXXXXXXXXXXXXXX
