--------------------------------------------------------------------------------------------------------------------------------------------------------------------------------------------------------
--------------------------------------------------------------------------------------------------------------------------------------------------------------------------------------------------------
--------------------------------------------------------------------------------------------------------------------------------------------------------------------------------------------------------
-----oX-----?o-BM--------------o--M---Xo--o----M--X-----------o-M--X---o-o---X------X-o-XX-------------------o-o----X--o-------M--o-B-----M-----o-X--X---XB------M--XM--M-o---o------X---------X--------
--------X-X---?---o--X-------X------o------X----o------X-?-----------Xo--oM-----o-X--o--X---M-o-----B?o---o--XX--?o---X--oX?-X----------X----X---o-?---B----o------------------Xo-X-M---Xo------------?-
--X-XX-----X---X-o-o---X-X-----M--?-X-X--X----M---o---XX---------B------o---X-o---X-B-X---------B------XX------X--o?X-------B-o-oBo---X-------X---------Bo--XMM----?-------XX-----X---------------X-?---
--------X---X----------------X-----------------B-----X--------M---X-----------o-XX------M-o---o-o--oo---Xo-----------------?------------------B-----X---------E----------XX---oX--------B---------------
------?--o---o-M---o---o--XX--o---------X-XoB-?XXMM-BX---o-X---------o-oX----------oo------X------o---o---o---o--Xo-oX-B-o---XX-X--M----o--------M-X-X--X--?M-XX------XM-o-M----o--?--XX---MoBXooBX-X--v
----------o------X-------X-X?-BXX--B-----o---------?--B-X------M---oB-----X------o---o?--X--XM------X------Mo---oX-X-------BX------------------?---X--------------X-----X----?---------o--------------Bf
--o-----------o--o--------------------------ooX-----B-----------M----X---------oMXo----X------?---M-----X-------------------o-M--------X------------oB--o----o-------XB-----------------X-----M---B----f
-------oX---oo-----o--X--------M-B----------------?-------X-X------o--X-o-X-oo-----M-o----------o--M---o-X----o------------o---X---X-----X-MX-B--o---X-X--o-----X-X---X-o--X?B-------o--X-X-------Xo--Mf
------o---oBXX------------X---------X---XX-X-o-----X--XX------X-X---------o---------B-o-X--oo--o--------?----o----BB----------Xo-X--X----------X--B-----B-----X-----o---Bo-------o-XM-----B---ooX---o--f
--?----o-------XM-B-----X--M--X-XoX--B---o--------B-------oo-X------X--X-?-o--------------o--o-------o--------X-?-------X---X---------Boo---X----o-X---oX----X-----?--o--------------X-M--------XB---T-f
-----o-----BB----------X--------------X------X--X-----------XX-?----X-----o----------------X---------------X-X---B---?---?-----X--B-------?X--X----oX----BX----X----o-X----M-----X-o--------------BB-|-f
m---------Xo------X--------X--X-------------X--------X---XB------o----X-----X---o-------X--o----B----------------------B----------XX--X-B--Xo-------oXo--X----X-o-------------X--o-B---o-B-o--X---X--XXX
XXXXXX-XXX-X-XXXXX-XX-XXXXXXXX-XXX-XXXXXXXXXXXXXXXXXXXXXXXXXXXXXXXXX-XXXXXXXXXXXXXXXXXXXXXXXX-XXXXXXXXXXXX-XXXX-XXXXXXXXXXXXXXXXXXXXXXXXXXXXXXXXXXXXXXXXXXXXXXXXXXXXXXXXXXXXXXXXXXXXXXXXXXXXXXXXXXXXXXXX
