--------------------------------------------------------------------------------------------------------------------------------------------------------------------------------------------------------
--------------------------------------------------------------------------------------------------------------------------------------------------------------------------------------------------------
--------------------------------------------------------------------------------------------------------------------------------------------------------------------------------------------------------
--------X--M?--X-B--------------M---------X--------XBXX?-B-----X--------o-X---o-X---B-?---------------------o-------------------BM--X--------XX-----?X-------oo----X---------X------X-B---?XMo--X-o--X--
--Xo----X-----------M-X-o--?-X-----X----o----------E-----X---X---------M----X-------------M-------BB----o--B-?-----o-B---------B---------o-oM---------X---o---o-------o-o-M-----X-o---------------------
-----oXM-X--X----?---X-----------------X-M---------B---?-----------B-----X---M---oo----X----o---X--------------------------o---------o--X-------X--M-?--X------B---X---------XX------?-o---?----------X-
--B----------------X---o----?-X-------------o---X--B-E--o-----?------MB---------X--o---o----B-----XM--B---o-----------X-----X---------X-X---?----o----o------X-XXME--?-o---B-----MM-------------o?X-o---
----?--o-B---------oo---o----------------X----?--B---X----M-------M------------X------o-------XX-X--------------X-----X-----o----X-----X-X---X--------------------XB----X----M-X-----M--o------X-------v
----------M-X----------M----?---o--X--BXE-------Bo-X--M----M-oo-B---E-X---o-?-------M--------------o---------M--o?-----------------------------XM-X--X--o---o----------B--------M--------------------X-f
------------------------------X-B-------M-X-o-----X-----o--E--------?-----------B?------o--o-B--------X?-------------o----o------B-----------o---o----?---X-o------X---o----X-----XX---oX---XX-o------Xf
-------M--Xo--XM---o----------------------------X------M---M---X--------------o----X-?---M-----------------o--?-o---------o--------o---------------X-------------B-------------B--o-------X-------XX---f
-------------o--X----oX-M---M-M----?---o-X--------o-----X-----XX-X-----------?--M-------------X---------------------X------------------o---X-----X------MM-M-o-B--Xo---o-M---M--XM--X------X-------X-XBf
-------o--------X---------------o----XB----------?-o------------------o---X---------------X-----------M-------M----o--X---MTX----o----X--------------XT-------------B-oE--??---------o-XX-o--B--------Xf
---B-----------X-B------------------o-----o----------X---X----------o-----------X-BB-o-------------------o-M---X-----X-----|------XBM--o---B----------|----oX---X-----XX-----o-?-o-----X----XX-o---X-o-f
m---XX-------X-----------------X----o-X-X-------------o--------oX---o-X-----o-X---------X--oX-------------------------X----X-----------X--------BX--X-X-----X-X--B--X-X-Xo--------XB-X--X---X--X-o----XX
XXXXXXXXXXXXXXXXXXXXXXXXXXX-XXXXXX--X-XXXXXXXX-X-XXXXXXXXXXXX-XXXXX-XXXXXXXXXXXXXXXXXXXXXXXXXXXXXXXXX--XX-XXXXXXXXXXXXXXXX-XXX-XXXXXXXXXXXXXXXXXXXXXXXXXXXXXXXXXXXXXXXXXXXXXXXXXXXXXXXXXXXXXXXXXXXXXXXXX
