--------------------------------------------------------------------------------------------------------------------------------------------------------------------------------------------------------
--------------------------------------------------------------------------------------------------------------------------------------------------------------------------------------------------------
--------------------------------------------------------------------------------------------------------------------------------------------------------------------------------------------------------
---X-------------X--------?--o-----M----o------X---------M?--XX--XoBX--MM------?X---o--?X-E----X---o----X?M---X-----X------------------Mo-MMB------o---------------o-M------X---?---------------------X-
---XM---o--X-----------XX----X---X-------o--o-----XX---------------------?-?-X---X------oXXMX-----o--------o-----------XMX-----XXX-B-o--------X---------X----------X--o-------X--M---X--?---------B---X-
------X---M-BX----o-----X----------o-----X---?-X----oo-----?-X---o-X---?-----B-X---X-X-X-----X---B--M---X?o--XB-----------------X-B----oBB--X--------o--oXB--X-X-X--X---M-------------X-------?-?-B-?X--
-o------B--------o-B--o--B-------XM------------B--??---------------B-----oB-------------M--o----o----Xo------B----o-o----M-o--o------M--BX---X?---X--X----------MXMX--------o---MX--oo------------------
----M-----B-?M------------o---------o-----B---------o--o-------X-----X------------X-X---------?-----M---X---o----M-M-o----o---X?-o-M---B---B?--?-------------o----------o---X-----?------?----o----?---v
-oX------------o-----?--X---X---o--o---------o--X-MX--------B-------X--X-B-----X------oM--X----------------o----------X?--------------o-------------o----XX----o----oB-M--M-----?--X-o----MB-X-o-----X-f
-----------------MX----X---X--o---B------------------X--------?MX------------------------o--M------------M----?---------------?--Xo-M-X---B-----?o----oX-o----o--------------oX------------------o--?--f
----X---X--?---?--------X----X-X-X---o----X-B--o---o-X-----o-----oX------------o-X---X-oM----o-------oB-----X-------Xo------M-----------B---Xo----o-?-------o---o--??----M---oBX--o-X-Xo-X---?----?---of
----------------------X-------------?X--o-----X--------o-X---MX--B-X-----o---M----X------------------B----Xo-B--------oo-X---Mo------------?----o------o--B---o-X---------------o-X--B--X----------X---f
----------X-----------B--B-B------------E---M---X-----X---------X-B-BX--X-----Xo---o---------M----------T-----o-B------B----------T------X---------o----o---XX----------B--------M-B-----BXX----XB--B--f
-X-MB-?----XX-o--------o---oX-----o--o-X?-------oo-----M---o-oB--BX---o----------X--X----B------o-------|-------X--oM-M---o----X--|---------o-X-XB-----?-----XX---X-B??-BB----?--------M-oB---X------XBf
m----------X--XB------o---------X------------XX-----------B--------------o--X--oo-----------X-----------X------X--X------X--------X----o------Bo----X--------B-----o----o--------X------X-X----Xo-XX--XX
XX-XXXX-XXXXXXXX-XXXXXXXXXXXXXXX-XXXXXXXXXXX-XXXXXXXXXXXXXXXXXXX-XXXXXXXXXXXXXXXXXXXXXXXXXXXXXXXXXXXXX-X-XXXX-X--XXXX-XXXXXXXXXXXXXXXXXXXXXXXXXXXXXXXXXXXXXXXXXXXXXXXXXXXXXXXXXXXXXXXXXXXXXXXXXXXXXXXXXX
