--------------------------------------------------------------------------------------------------------------------------------------------------------------------------------------------------------
--------------------------------------------------------------------------------------------------------------------------------------------------------------------------------------------------------
--------------------------------------------------------------------------------------------------------------------------------------------------------------------------------------------------------
-------------?--------------------------------o-------------------------M--M-B-------?------------------M-------------------?----------------------------M---------------------------------------?------
---X-------------------X-----------------------------oo----X----------X-------o--?-------o------------?----X------o--B-------------M--o-X---------?---------------------------?-----------X----o-o------
-------?-----------X-?-------?-Xo-X---------?-----------------?------------?----?-----------B?-X-----?----M-Bo--------?---------------X------------------XM--o----X---?----MX---------X-----------------
-------??--M---M-------------?--o---------------------M-------------------------B---------------------o---o------?-----X------------?--?-o?---------------------X----?---------------X------M-----------
---------X-------------------M---------o-----M-------M---?----M---------M---X-----o-----------------------------------B----------------X-----------------------------X---------------------------B-----v
------------?-------------?------M---------------?------?-M----------------X----X------------------------------X--M--M--X----X-------------?-------XB----------------------------------?---------------f
-----------M-----------------------M-------X--------------------------------------------------M-------B--o-----------------------------------------?----------------------------X------------o---X-X---f
--------o------------------M----------------------------------B-------?----X------------------------------------------?-------------M----M----------o------M----M-------------X----oo-----------M------f
---------------X--X----BX------X-------------o-X----X-XX-X-o-XX-------X--?----o----X---BXM----X-----------X---------X---o---X-------------------------------------M-------------------------X?-------?-f
---------?---M---------------------T----------X---M------------------------------BM-------------------------o---------------------------o-------B--------X-M-M---------M-----X-------------------M-----f
-------X------B------M----------------------------------o-------------------------------------M-----------------------------------E-B---------------------B--Bo-M-----------B-------M------o--XX---|---f
m------------------o-------------------------------------------X--------X----------------------------------------------------X------------------------------oo----------o---X-------------B---X----X---X
XX-XXXX-XXXXXXXXXXXXXXXXXXXXXXXXXXXXXXXXXXXX-XXX-XXX-XXXXXXX-XXXX--XXXX-XXX-XXXXXXXXXXXXXXXXXXXXXXXXXXXXXXX-XX-XXXXXXXXX-X-XXX-XXXXXXXXXXXXXXXXXXXXXXXXXXXXXXXXXXXXXXXXXXXXXXXXXXXXXXXXXXXXXXXXXXXXXXXXX
