--------------------------------------------------------------------------------------------------------------------------------------------------------------------------------------------------------
--------------------------------------------------------------------------------------------------------------------------------------------------------------------------------------------------------
--------------------------------------------------------------------------------------------------------------------------------------------------------------------------------------------------------
---o----o----------X------------Xo-o--o-M-------o-o------------------X-B---XE-----o-?--?----------?-------o----o----------MX-----------------o-oX---------------oo----oo-o---?B---------------o--?X-----
----X-----------------X-------?------o---X-?----------o------X-----X---B-X--?-o-o-------X--o-o-B---B?-------------o-B-X----X----------B--X-----o-----------M------XX------------oXo-X-----?--------M----
--oMo----XM-------X----B--o------X------X-----X--X-X----------M----------------o-XX-X---------------------?-------B--------------X--o--o--X-o-o------B-----------?-X----o--XXB-------------X--------X---
-----------M---MX-------X---------------o---o--------o-------------------------------oM---------B-----B--------------M--------X-X-------------X------o----M--o----o-----------------MX-----X-----X------
--X--B-----------------X-------------------------XX---B--MX---oBX--------B--B------------Eo-M-X-----------oX---?---B--o----X--------------X-o----M--M-o-----------X---M-------------------------M-----Mv
-X-----B-X----o-------B----------X----------X-?--XB--o-o----B-----------------X-??o------X------X?--MXX----X------------B----------X--------X----------X--?---XX-X-M----X-?-E--X------------X-------?--f
----M-----------o---MX----------M----o-------------?----X-----Xo---o---X---M?------?M-------M-----------BM----o-------M-----------M--o-----X------?-----o--B---o------------M----------?-M-------------f
-------X--X--B----------X----X---------B---B-------------------------X--------------------------------o-------------X------------------------B------X--X-X-----------o-----------M--X-------o-XooX---B-f
-o-oXX-o-XB?X-X--X----MX-X--X-XXo-XXXXX---XXXXXXXB-XXBX-X-X-XX--XMXX--X--XX-XXX-XXX--X--EB-X-XBXBXXXX--XX?X--XMM--X--X-XX---XXX--Xo-Mo---o-M--------E-M-------X---o---X-?X----X---------------o---Xoo--f
---X-X--B------X-----------------------------------------o--------------X-----------M---X-------------------o---B---------X-----X----X--X-----X-----M--X------------M---------B--X---X-o--M----?----X-Xf
--M-----X??X------M--E-----XM---------?--------------------o----------Mo-------------?-----X---------X----------X---------B-----o-XM----o------X-----------?---------X------B----X--M-XB--------X------f
m--------------X-----XX---------o-B------------X-------X-----X------------XX-----------X-------X---B---o---Xo--------------X---X--------oB--------X--XX------X-------XXB--X---X--------X-B----X-XB-X-X-X
XXXXXXXXXXXXX-XXXXXXXXXXXXXXXXXXXXX-XX--XXX-XX-XXXXXX-XXXXXXXXXXXXX-XXXXXXXXXX-XXXXXXXXXXXXXXXXXXXXXXXXXXXXXXXXXXXXXXXXXX-XXX-XXXXXXXXXXXXXXXXXXXXXXXXXXXXXXXXXXXXXXXXXXXXXXXXXXXXXXXXXXXXXXXXXXXXXXXXXX
