--------------------------------------------------------------------------------------------------------------------------------------------------------------------------------------------------------
--------------------------------------------------------------------------------------------------------------------------------------------------------------------------------------------------------
--------------------------------------------------------------------------------------------------------------------------------------------------------------------------------------------------------
-----EXMo---------XX----M-----MX---------M--------?-M---M----oX-----------------o-?Mo------M----o------------------X-X--------------X---X------o-------X----------B----X----BoX---o-----------B---MBX---
--X--M---o-M----------B-----------M-------?B---XM------------X--B-X---------B-----------------------------M-?--X---------MBo-oX----X------M----X--o---------X-M---B--M--?--X---M-----M----------------X-
---o--X------X-----X-o----?-----------------B-----o---?---------------X---X--??-X-----?BB---------?--Boo------XXXo----o--------B-oX--------X--X--X-----X-o---------o-----BM-?---M--X---?------------??--
-X-------?------X---o------?X-X-B----?--------------o--X--M-oo-X-?--o---M--------B--X-----o-X---o--XX---------o---------------oXo----B--M--X--o---B-B-o------oX----B--X-M-----------oo---X-?----B-------
----X------X-----B--oo-X-----------------------------o---------------?-------B?-o----B---X---XXo---X----?---X--------B?----------X-----------M-----B-o----X---------------X-------o-----oo----XX---o---v
--M--o--B---------------M--------------XX?ooB--Xoo----------------X------X-----X-------M------------B-----X--X----X------X--oo----BM-----oM---?-----X-------o--------Xo-o---ooX--?Xoo-------XX--?----M-f
--------X---X--XX--?-----o-----B----X-X---------X-B------X--?----o--B------------o-o----?M-B-------?--X-------XXX--o------Mo--X------------------o----MX-----------------------o-----o-o---oX---------Xf
---------X-------------X-----B-X--o--o--BBXMX--B-X----X-------------------X---------------o------X---------MX-----------------oX--o---XB-o--o---o--------------XX?Bo------X--o-------oX--B---MXX------of
--------X------X---o-----XB--------------------B--------o----M-B--?o-M-X-o---------o--M------------X------------M----Moo-------------------XXX----X-?----oX-------X-X-X--------------------B----o---M--f
-M-?-X------------X---X-X---------X?X-oB-----o------------o---X--------X-----Boo--oo---XM---X---?M----------?-?------------o----E----?--------X-B-------X---oX-------B----o---X---------oXX------B---B-f
------oX-X---?M-o--o------?---o------?---M----o--------X-Bo-----M-----o--B?-M--------------XXX----MoB----M-----X?ooXo---------X-?---------Xo-o--XBM--------B------X---B?-oX?-BX--o----?---B----M--X-oX-f
m----------X------------------B-------------XX-----o-----X--o--------o---------X------X---------------X-----X--------X----------------X--------------B---B-X--o-B-X------------XX---X-----XB----X-XB-XBX
X-XX--XXXXXXXXXXX-X-X-XXXXXXXXXXXX-XXXX-XXX-XXXXXXXXXXXXXXXXXX-X-XXXXXXXX-XXXXXXXXXX-XX-XX-XXXXXXXXXXXXXXXXX-XXX-XXXX-XXXXXXXXXXXXXXXXXXXXXXXXXXXXXXXXXXXXXXXXXXXXXXXXXXXXXXXXXXXXXXXXXXXXXXXXXXXXXXXXXX
