--------------------------------------------------------------------------------------------------------------------------------------------------------------------------------------------------------
--------------------------------------------------------------------------------------------------------------------------------------------------------------------------------------------------------
--------------------------------------------------------------------------------------------------------------------------------------------------------------------------------------------------------
------------B-----------X------------X----X-X------B-B-M----X---o-o------------X-----------------o-------------Xo---X---M?--o?o-o------?-------B------o?------X-B--oM-------?-----?------B---o----------
----XB---X----------------------B--M-B-----B-------X-------X----------?--o--X----M-------------X---------------------------B--X------o----?--oo---?M-------X-----o--------?------------MM---------------
---o---------MX----o-X---X-----?------o-------X---------B---------X------------?------Xo---X--M-----X-X----X---------B---------X---------------X-----o---o?-------XX--?--------o-----B-----?---oX---B---
-------?-oX-------X-X------M-o---M---o------B--X------X---X---------oo-o--X-------X-------------o-X----Xo------------------?-?-----oX-X-X-Xo-X-------------X--X--------------B---X--o---------BX--------
-?X-Mo------?---X-------B----------?-----X----XX---------X--X---------------------------------?---------X-M----?----------------?---X--oX-------B---?------B-----o-----o-X--------o-----B--------X-----v
---------------------X--------------------?-----------------X---XX-----X--M--X------o--B?o------------M---------X--X------------------------?-X-o-----X--o?-X---oXB------B---X-----Xo?----MB----B--X--Bf
--o---------X-M-B----------------X----?o---------------X?X----X----X-----------------M-------------------------------MB-----?-X----X--XXB--------o---o--------------o---o--------------X---XoM-X--o----f
--------o-------B------X-?----X-----------o--oBXX-oX----------o----------X--M--?--------------?--X--------o-M-----------oM---------XXXB--------o-------X-----M?----------BX------?-X-X---B-------------f
---------?--o-------o--X-----------Xo--o--------------X---M--X--B---------?--X------------------B-M----------B-o-----M----------XB-----------------XX---o-----------o-X---X--XX---------X------XM--X-X-f
----------B--M-------------------X-----X-XX?--Xo-----X-----------?--M----------------?M--------B---o-o----------o--------o--------------X----M----o------X-----------X-oX---o---------BX-X?-B-?--------f
--X-----------X------------------------------------B--------o---------------------X------M-------X----X-----X------BX----X--o---M-B-------oX--?-------X----------?B------X------o?---B-----------X---o-f
mXXo---X-o--X--X-XX-X------------------------X----------X-----------oX-X-X-----X------XX--------------X------------------B---------------B------X-B---Xoo---------B-X---X---X-----XXB---o---BXo-XX-o-XXX
XXXXXXX-XXXXXXXX-XXXXXX-XXX-X-XXXXXXX-XXX-XXXXXXXX-XX-XXXXXXXXXXXXXXXXXXX-XXXXXXXXXXXXXXXXXXX--XXXXXXXXXXX-XXX--XXX-XXXXXXXXXXXXXXXXXXXXXXXXXXXXXXXXXXXXXXXXXXXXXXXXXXXXXXXXXXXXXXXXXXXXXXXXXXXXXXXXXXXX
