--------------------------------------------------------------------------------------------------------------------------------------------------------------------------------------------------------
--------------------------------------------------------------------------------------------------------------------------------------------------------------------------------------------------------
--------------------------------------------------------------------------------------------------------------------------------------------------------------------------------------------------------
--MM----------B----X-----------------o-----X-----------X-M-?-------X---X-----------------?-------------------------------X-----o--BoB?X------X-o---o----M?-?----M--?---?-----X-oX-X---oB-X--------M-----
----BB-----?----X------------o-?-M?---------?X------X-------X----?--X---o---------X----------------------------------M---------B-M-----M--?---------M-------M--------------X---------X---------------X--
------X-------------M-??----X----------X--o--o-----o---X-------?---X-XX-----oX---X-----B-------X?B----o----B---X-------?-?--------X---------XX--?-------oB---X----M-X--oX------B-B-o---------X----M---o-
----B-------X-----------X---BXo--X----o-------------B-o----------------XoB-------X-MMX-o----------?B--------o-----X--B------X-----------o-----M--?-X--X-------oo---B--B-----------B---o----X---Xo---o-X-
---M-X----X----------------------o----o----?------o------XM---------X--------X--X-------------X----B--M-M--o--------M-B-------------M----------M--------M-BX---------M----o-X---B--------?MX-X-------X-v
----B----X-oX-----------------------X----M--X----B---------X---B-o-X-?--Xo--X-----BX----------------------X-----X----------o---o-------o---XB--------------B----o--------?-Bo------X----------o-------of
-X---M-------XXM-------------X-----X-------o--X----?--------------?X-------M----------M-----o------X-----------o----X-----B------M--o-------X-Bo-X--Xo-oM-----X--X---o----X-----X---X---X-?X-X---------f
-X--------------B-------X---E--X------o-----M------------------------?--X----X-----------------------X--X--------Xo------------------o-?---?--X----------oB--------------B---X-o---Boo-o------------MX-f
--X-------X-o------------?-BX-B-o--B---------X----X-----------X---o---?-------X----------XX------XXB-X--X--XB-------MB--M-X-----o-o------------BXoo------------M--Bo-B-X--o--X----------?----X---------f
----------o---------M-----X--o---------------X------X-----------------------X---------X-------To------M--o------------------o-BX-o---BX---X---M-----X----oM----------o---M--B--X--M---B--?----X--------f
-------------MX--------o------------o----?--o-----B------M------?o-o-oX-----------X-----------|-?---M----------X--------?-o-----------X-?--B?---?--B--?B---?-------X---------X---------------X------oo-f
m---X-----X--------------------XX----X-------X--X---B-------------------X-o-------------------X----------o-o---X-----X---o------X---------B---------------------XXoXXX-------o--B---X-----B--X---X----XX
XXXXXXX---XXXXXXXXX-XXXXXXXXXXXXX-XXXXXXXXX-XXX---XXXX-XXXXXXX-XXXXXXXXXXXXXXXXXXXXXX-XXXXXXX-XXXXXXXXXX-XXXXXXXXX-X-XXXXXXXXXXXXXXXXXXXXXXXXXXXXXXXXXXXXXXXXXXXXXXXXXXXXXXXXXXXXXXXXXXXXXXXXXXXXXXXXXXX
