--------------------------------------------------------------------------------------------------------------------------------------------------------------------------------------------------------
--------------------------------------------------------------------------------------------------------------------------------------------------------------------------------------------------------
--------------------------------------------------------------------------------------------------------------------------------------------------------------------------------------------------------
-X--?--BXX-----o-----B-X-------M-------X---o-------B---X---?M-------o---M?XB-M--------?X---X-M----X--B-XX----X-------X-------X---X---?M?--o------X---B---M---o-------M-----X-XXX--o--------X---------o--
--------Xo-o-X--------B-o---------M-----o---X---------------------M?-----------?----B---B--------B------o--?------Mo--XM-oX-----------------------o---XB---M?o----Xo------------Xo----o----o------o-----
--MB------X-X--BX-----------X-------o------X---X-B----o---??---------X-------o----M-------------o----?------XX--M--------------------?--X----?B-X-Bo-oX-oXE--------XX---o----X-?X------------X----XX----
----oo--M----------o-o---X-?B---------------o-----------------------?----o-------------?---X-------------oX----------M---------------------?-----o--oX----X---------------------------B--X--X-------o---
---X-B---M--------M----?-----------B-----X---------------------M?----X--X-----------------------------------B-o-------B------?--------M-----X---M-------o--B--o-o?----?--------X---X--X--B--X--X?------v
------------X--------------MM-o-o--X------?---------MX------X-------------o------------X--o-------------X---oo--------o-BM------X-?----o-?X----------X?-----o-----X----X--XX--Xo-----X-----M------X----f
----X---XM-----?-X-------X------------X-----oo-M------X--X--------?-------------M-------o---------?--?o---X------MX-----------X------o------o-X---B-------------------------B---X------XX----X--X-XXXE-f
----------M--------------o-o----------------------------X--o----------?-----oX-------------?-------------XXo-X-o------M--------X--oXM-o------o-XB-o-X-X---X-M-Bo-o-------?M-------o-X--X----B--------X-f
---XM--------o-----------------?--B-----B----------X---X--o----o-------------o-----------------X---o---------------------o---------------B-------X---XX--o-----------o-----X--MX---X------X----XB------f
-o------?--oM--B--X-M---X-------o---X----X------------?X------X----ME-o-------------X-----B--------X-?-?-----o-------X---------B------oo--oo--X----o----X--------------------------o-oMXX---o-------M-Xf
------?--o-----------X----X---------o-------------B-o-----XX----o---M----M---------X----------?o--o-----oo---XX-------X---B------------o------------------------B--X---------?----o-X-------XX----X----f
m-X------Bo-X--------B-o---X---Xo--------X----------oXo-o-----X---X---X----o--X---------B--BX--------o-o-----X------X--X----------------o--o------XB---X----Xo---B----o-B-------X-oXXoXX-X--B-o-X--X--XX
XXXXXXX-XXXX-XX-XX--XXXXXXXXXXXXXXXXXXXX-XX-XXX-XXX-XXXXXXXXXX--X--XXXXXXXXXXXXXX-XX-XXXXXXXXXXX--XXXXXXXXXXXXXXXXXXXXXXXXXXXXXXXXXXXXXXXXXXXXXXXXXXXXXXXXXXXXXXXXXXXXXXXXXXXXXXXXXXXXXXXXXXXXXXXXXXXXXX
