--------------------------------------------------------------------------------------------------------------------------------------------------------------------------------------------------------
--------------------------------------------------------------------------------------------------------------------------------------------------------------------------------------------------------
--------------------------------------------------------------------------------------------------------------------------------------------------------------------------------------------------------
--o-X------------------o--------------o----M--X??X-----------o-M------X---X-X-o-------o-----M----o-----B-------?o-X---B-Bo?------o--o------o------o---M--?--?------X---------MMX----------------------X-
---X------------B-------------X--o-----XX----------o-?----X-X----M-?-----X-o---B-------M------oM-----------MX----M--XM------M------?-E-o--------M--o---X-----X--M-----------------B--B----X---o--o--M---
------o----------?-------------------M--X--------------------X----------M------------B---?---?---X------------------------?--?-M-X---M--X-----M-----o------------Xo-----o----X--X-------X---X-----------
-----------?-B------oM---B--B--M---------o?--X--------X-?---X-----?-------o-X---o-------------------X-X---X----------M----------B---E-------B--o-----B----------------------------o---o---------X---X---
-o----?-----------------o----X--M------------------o-?-----?---------o--------?---M-------------o-?M------X---M-------Xo------------M-B-----------------XM-X-----M---------o---MX--------X-----B---X---v
----------------?---X---oB--X----X---oM-------XX------------------B--B----?-----------XMX------------M------------o-------------M---------X--?--o-----------?----------------------------Xo-------o----f
----M-----------------------o?--------------------------X---------o-B---------MX---B-----o?-----X-M---oo---?--X-------X---?----------X---?-X------------------X-X-------------B-XM----X-o--XX---X-X-X--f
----------------X-------------X-B----E-o----------B--------X----------------------------B-----oo--------B---------------M-------------X-----X---------?----B-----o-----XM----M----B------B?------o--o--f
----XX-X----XXM---XX-X------XX--X-X-XX---X---XXX-XXMXo-XX-?-X--XX-X----X-Xo--X--XX--XX-----??XXoXX-XX-MXXXM--XXM----X----XMM-XX-------X-------M--X--X-----o--B----X---X----?--M-------o----X-X--------Xf
--X------------BB---------X--B-------o-----o----------XE------M-------------o-----Xo--o--------------------To-------o-X-?------XXo----------?--X----o-o-------o-?------X---------------E-----X-B-------f
------X----------o----XX-----------X--B---X----?B-----XX-X-o----?---?X-M-X--X------------X--M--------------|---------o----BX----------?---X-----M--X-------B---------oM--o-------------X-B----XX--X----f
m-BXX-o--Xo----X-----XB-----X--XX------------X---X----X-o---------------------o--------X-B----XX----o------X--X-XX-----XX-----------X------B--------------------B-----------X-----XX-----X----X-------XX
XXXXXXXX-XXXX-XXXXXXXXXXXXXXXXXXXXX-XXXXXXXXXXXXXXXXX-XXXXXXXXXX-XXXXXXX-XXXXXXXXXXXXXXXXXXXXX-XXXXXXX-XXX-XXX-XXXXXXXXXXXXXXXX-XXXXXXXXXXXXXXXXXXXXXXXXXXXXXXXXXXXXXXXXXXXXXXXXXXXXXXXXXXXXXXXXXXXXXXXX
