--------------------------------------------------------------------------------------------------------------------------------------------------------------------------------------------------------
--------------------------------------------------------------------------------------------------------------------------------------------------------------------------------------------------------
--------------------------------------------------------------------------------------------------------------------------------------------------------------------------------------------------------
--M------X-----------------X-------------------------B-?-----------X------------?---------X-X-------?--X------M----------------o--BX---------X--X--o----M----o------X---?-M--X-o-------BoX-----X------?-
---M--X-?B------?----------XX-B--M----?----?---M------------M-----------o----Xo------X-----X---------X-------------------------B-o----MMM--X--?------X--------o--------------------------o?-------------
------------------X-X-------X--o--?------?------E------------X-o----MX-----o-X--B?---X----o----X--XX---M-----oB--------?--M--X----oX-----o-------o---oo-XB---M---------Xo--o-----BMoX--M---M--X---------
----o----?--X---X-------X-------------B-------X-?-M--------------X-----------------M-----oo--M----BBX---------BX------------XX----------------X-o-MX?--o-X-----oo-----B-o---o?------------------?-M-o---
--X-----------?----------------o?oX---o--------------?--X-----B----------B----?-o------?--------------MMM--o-----o--M----------X--X---X-X---M--M-------------------B-M---?------o---------oB?-?--------v
-----o-Mo-----------o------X----------------X----B---------Xo-XB---M---X--X-------M-----B-----o-----------X----oX-X--------------o-?---X--B----------------BM----MX--------X-----------o----------o---of
---X--------B-------------------------Xo----------X-----o------------o------o-------X-----------X-M-o----------o-?--------M---o?-----?-----BB---B---X--o-------------X-oo-X-------?-o--XX--XXX------X--f
----X----------?B---B-Xo-----oX-------XB-----X---M----o-----X-------X----B------------------o--X---X-X---------------------XM----------------------X-?------M-?---------o---o--------X?EX--X---o-oX--X-f
--X--M--X-X-----------B--o--X-B--------------X--------o------o-?--------M-------o---------X--X--M-X--------X-?--?---M---M------------?-o-------o-X----oo-------Mo-X----X-?oo-X---M-X---B----X---?-o----f
-M---------------o--o---?------o--XX-------M----X------o---------E-------------o--o-----X---------X---Mo-----------------X-------o------M-------------B-----X----o---oo----o--o---?--oo----?--X-------Xf
-----X---------------------------------------------X-B------X-M--X----X-------------?------BBX---X-------E-----X-X------X--------X----?---B----M?--B----------------o--------X--M--B----?----X-----Xo--f
mX----------------X-------------XX---X-----oBXX-------------o----------o-----X----X--X---------o---o-----X----------------------X-oB----o-B-------B---X----------XoXX----oo--o--------X-----XXo-------XX
XXXXXXXXXXXX-X--XXXX-X-XXXX-XX-XXXXXXXXXXXXXXXX-XXXXX-XX-X-XXXXXXXXXXXXXXX-XX-XXXXXXXXXXXXXXXXXXXXXXXXXXXX-XXXXXXXX-XX--XXXX-XXXXXXXXXXXXXXXXXXXXXXXXXXXXXXXXXXXXXXXXXXXXXXXXXXXXXXXXXXXXXXXXXXXXXXXXXXX
