--------------------------------------------------------------------------------------------------------------------------------------------------------------------------------------------------------
--------------------------------------------------------------------------------------------------------------------------------------------------------------------------------------------------------
--------------------------------------------------------------------------------------------------------------------------------------------------------------------------------------------------------
--oM-BMoX?-----oB--B--o----------oX---o--------------B-X-o----oo-o-B------?-----B------X----X---o-----o--X-oX----X-o-----X-------M-?BM-Xo?X----------------oo-------X--B-?----o-M---------X---o-----B---
------------X--------M-------X--B-oX----M---o---o-----o---X-X-o---------------------M---M-B-o-XM--------o----XX------o-Xoo-------------------o-X-X-o-o--X-----o---?o------XX-B-------MX-B-------X----X--
-----o-o----------?o----o-XXo-X?-X--------X--------B----XBXB----X--BoX-XX----?M---o--??---------Xo-X-----o-o-------o-------XX--MB-o--X-B-X--?-----X----o-?-----X---B-----o-------o-B----------------o-o-
-Mo-X----X-----M----o--o-o------X----M------B---X----X--------------------X----X-X------o----B-?X-Xo--M-X----XXo----------B--------Xo-----------o----------B--------MM--M-----------o-B--?---BX-?-----X-
-------XXo--Mo---B---BB-------o-------o----X--o----X-X-----X-o----------o-----X--BMoo---oB-----------------X-----oo-o--B-X-----E---X--X-------X--M?-X--o-BX--B-X-X----?---o---?-B------o--M--X-----o---v
---o----B-o---B-XXo----X---X--BXX--X----o--o-B---------MBB-ooo---?M---X--------o-------X-----X-oo-B-X--------o-XX-----X-----B-oMXo---------o-------X---o-X-M----------------X----X---B-o---------------f
----o-X------o-------o?---X--o-X-BX-------------XM--X------------------------X-o-------------o-X-o--X-X----o----------------o-----o-?---X-o-o----BM-B-X------o------o--o-----------o-oX---B----X--B-X--f
-?--X--X---------------BM-----B------------o---o---X---?----?o-o-M--o-X-MX----o-----B-X---XX-------------X-------X------B----o-X------o---B-X------------X-X---M-E-o---o-----X---oX------X-o----?------f
--o---------X--o?--M--?---X--X--o--M---X--B--BX--o--------X--o-------X---o?-----XX-oo----oo--------B?--------M---X------------XB--X----Mo------Xoo---oo-o-------M?-X-o---o---------oX---------B--o-B-Bof
------X--oBX-o-----------o-oo--M----XB--o-----B------o-----?----o------o------?M-------o---XXo----------?-o---------X---o----------oo-----BX-Bo---o----o-----oo------X----B--o-------X---X-X--XB-----BBf
--oo-o--o-BB---o---X------------B----oo-X--X-----------oX----o----o--X-X?--o----X-B--B--XX-----------?o--o--ooB----o-XM----Xo-----B-------------o-------------X--X-X----X---Moo?B-oo---XX--X-o-X--X----f
m---------------X----BX----X------o-------X--------X--B------X------X----X--X-X---X-----X----X----------X------------------B----X--X-X---X-oB-------o-oo------------X--------X-----B-------X--XX------XX
XXXXXXXXXXXXXXXXXXXX-XXXXXXXXXXXXXXX-XXXXXXXXXXXXXXXX-XXXXXX-XXXXXXXXXXXXX-XXXX-XXXXXXXXXXXXXXXXXXXX-X-XXXXXXXXXXXX-XXXXXXXXXXXXXXXXXXXXXXXXXXXXXXXXXXXXXXXXXXXXXXXXXXXXXXXXXXXXXXXXXXXXXXXXXXXXXXXXXXXX
