--------------------------------------------------------------------------------------------------------------------------------------------------------------------------------------------------------
--------------------------------------------------------------------------------------------------------------------------------------------------------------------------------------------------------
--------------------------------------------------------------------------------------------------------------------------------------------------------------------------------------------------------
--------------------------------------------------------------------------------------------------------------------------------------------------------------------------------------------------------
-------------------------------------------------------------------------------------------------------------------------------------------------------------------------------------------------------f
--------------------------------------------------------------------------------------------------------------------------------------------------------------------------------------------------------
--------------------------------------------------------------------------------------------------------------------------------------------------------------------------------------------------------
--------------------------------------------------------------------------------------------------------------------------------------------------------------------------------------------------------
----------------------------X--XX-------------------X-X-X----------------X-----------------X-----------X------X----------------------X--------------------X----X------X--------------------------------f
mX----------X----------X-----XX-X------X--X------------X-X-----------------------------------------------XX---------X-X---X-----X-X--X-----X----X----------------------X-X------X------X---------------X
X------X-X----------X-------X------XXX--X------------XXX------X--XX---X------X----X------X----X-X--XX----XX------------X------------------------X---------XX--------X-X-X-X-X---------------XX-----X---X
-X-X--XX-------X----X---X---XX---X-XX--XX--X-XX-------XXX-X-XX-XX------XX-X--XX------XXX-X-XX-XX-X--------X-------X-X--X-----X--X---XXX----X-XX--X----XX-X-----XXX---X-X-X----X----------------X-----X-v
-----XX----XX-----X-X---------X------X-X-XX---X---XXX----X-------XXX------XX--X-------X-XX--X----------XXX-X--X-------X-XXXXX---XX-X---X---X-X-X-X-XX----------X--XXX-------X-------XX---X---XX--XXX-XXf
-----------------------------------X-----------------------------X-----X---------------------------X-----------X----X-----------------------X-----------------X---------------------------X------------f
-------------------------------------------------------------------------------------------------------------------------------------------------------------------------------------------------------f
-------------------------------------------X------------------------------------------------------------------------------------X-------X--------------------------------------------------------------f
