--------------------------------------------------------------------------------------------------------------------------------------------------------------------------------------------------------
--------------------------------------------------------------------------------------------------------------------------------------------------------------------------------------------------------
--------------------------------------------------------------------------------------------------------------------------------------------------------------------------------------------------------
-MX----M------o-----------?-X---X------XX-----M-X-----B----X--o---------------o----o----?----------X-X---------------M-oM--------B--B-------X-----X---X-----oM---X-------Bo----------------------?------
------------B--o-----o-------X--X---XM-------------B----------------------------oX--X?----X---X--------o---------X---------M-M-B-------Mo-------X-X--X----o---------M--Xo-------X---MM--o--o-B-----Bo-B-
---------X----------M-XXB------X--M---?----?-----E---------X-----o-X----?----B-----------------X---o----o------X----o---X?------M-BX---------B-------Xo-----?----M-------o-----Xo-B---X--B--------------
------o----M---X--X---------------------------M--M-------o---B----------------XXM--------X---M--X-----?M-X----M--------------X------------?--o---------?-X---o-X-----?--------------------X---M-----oX--
-------?----------X-BX------o----M?-X-o-X-Bo---------------------o------------o----o------M-----B-------M---------X--B--------M---------B--M-------Xo-----Xo----------?---o---o--o-----B?B--X----------v
-XB----------X--o-------o------------------B---X-X------------o---------o---M----o--?----------------X----o----XM-----X--MB-----M------X----X?------------B-oo-----MX---o---------MM--?--------o-B-----f
----M-XM-------M----X--o--XoX----M---M----------------?---?---o-B----X---M-------------?-M-----------B-----X-----B--------X--X?--B--X---o--?-----X---?oX-------------?X----X--------?---MM--o-M--B-----f
-------------X---------------X-----------------E-----------E-----------------X---------------M--------------oo-----------------B-----XM--B------o-B-----o-o-------------------M---?-------------X-----Xf
---X----ooXXM--XXX-X-X---XXX--XoXX---X--XXXX-X-XBXX?-XXXXXXXX---X--XXX-X--XX-oM-M-X--XX--XXX---oX-------X?XXoX--o-XXX-X--X---------X---X-----X------o----X---X------M-------o---------M-X--?--------o--f
-----o---------o-oX-B-------X---------oX------X------B-----------B----X------------------------o------o---o-------B------X--X--XX-XX----------B-X----XX-o--M------X-------M------TXX---------X---------f
-----XM------M-------o----M--X--B--E--------------o-B-----M-------------X-------B--o-Mo--------------BX-----B-X-----------------------o--X----XX------X------oo--o--?-o-B-------M|-----X-----oX--X-----f
m---------------o-----o------o-----X---X----B-------X-o-X-----o------X---X---X-------------X-------X-----X---------XBX--------------o------X----------B--------X--X----o-o----B--X----BB-------XXX-B-XXX
XXXX-XXXXXX-XXXXX-XXXXXXXX-XXXX-XXXXXXXXXX-XXX-XXXXXXXXXX---X-XXXXXXX-XXXXXX-XXXXXXXXXXXXXXXXXXXXXXXXXXXXXXX-X-XXXXXXXX-XXXXXXXXXXXXXXXXXXXXXXXXXXXXXXXXXXXXXXXXXXXXXXXXXXXXXXXXXXXXXXXXXXXXXXXXXXXXXXXX
