--------------------------------------------------------------------------------------------------------------------------------------------------------------------------------------------------------
--------------------------------------------------------------------------------------------------------------------------------------------------------------------------------------------------------
--------------------------------------------------------------------------------------------------------------------------------------------------------------------------------------------------------
-XM-M-X-----?---------o-X--?-?--E----??--------oMo---o------X---o--M--o--------------------M-------------X----------M----X-------?----X------------B--o-B-----------M--X-M-----o--?-------B---------X---
-----B-----------X-?X-B--------MB-------X----?------------X---------------X-----------------------?-------------------o-o-M--XX-----------?--Xo---o------------------?------X--o-----X--X----?------X---
-------X---------------------M--------o-o-----------------B-E-BX--XBX---------M?-----B--------?X-----oX--oX--------?-B-X----?--B-X---M--?--X-----------XXoo-------X?--M----M----?-BM-X---B------X----o--
------oB-oXM-----X--X-----------X-?---------M--X-----------MX----------o-X--X------------E-------------X-o---XB-----------X-----o--------X?--X--o-?--------o-X--M---X------------X--?--------X--o-------
--X--oo---------?----B--B-------X--------oo---X-------------X--o--?---------X-------X----M----X?------------------------M-------oB-----XX-----------X---------?--X----------o--M------X----B--------o--v
-------B-----oM--o------XX-o-oM------------------M---X-B-M-------------X--X--X---------B--------------M------------B--------M------o-X----o------X----B--oo----?-X-----X-B---X-----o---BX--------------f
--o?--o--?-----oB-M--o----o-M----------X----X--B--?--------B-B-o-------------o----------------B--------o------?------MB--------X-M------------------------------o---o--Xo--X--?-----------M-o-----?o---f
----XX-------X----------------------BB-----?---X---X------------XX--------o---o-X-X----------------?---o--oXB-----o---o-BM----------o-B----------M?----o--M-------B-o----BX------?-X-------oo----------f
------------X--------X-?--------------M--B---M-------oX?-----------------o----------o----E--M-?----------?X---o-----------M------B-------X-----M----X------X-------X-----------------?M-X--X-------X-M-f
---X-------------?--------oX------------------X-ooB--X---X-----?--X-------B--o-X-?-------BM----------o-------o--M----------o---------X----X-X-----o------M--o--X-X---X-X------?-X------X-XX----oB-----Xf
------o-?----B----o---M-------------MMBM-----o------------o--o--------X-X-X--X-B----MM-B---X--M--------------------o-----XX---M-M-?--o----B---o---oX-o--------X--B--------o----X-M-----------B---X--B--f
m--X--------------X---------XB-BX-o-----------X-----B-----------X--X-------------------XB-------------Xo-X---------X-B-------------------B-------------oo-X---------X----------X---X--------XX--oXX--X-X
XX-XXXXXX-XXXXX-XXXXXXXX-XXXXXXXXXXXXXXXXXXXXXXXXXXXX-XXXXXXXXX-XXXXXX-XXXXXXXXXXXXX-XX-XXXX-XXXX-XXXXXXXXXXXXXXXXXXXXXXXXXXXXXXXXXXXXXXXXXXXXXXXXXXXXXXXXXXXXXXXXXXXXXXXXXXXXXXXXXXXXXXXXXXXXXXXXXXXXXX
