--------------------------------------------------------------------------------------------------------------------------------------------------------------------------------------------------------
--------------------------------------------------------------------------------------------------------------------------------------------------------------------------------------------------------
--------------------------------------------------------------------------------------------------------------------------------------------------------------------------------------------------------
--o---X--M----X---X---X--?-----o-----X-?---X--o---X-XX--M-----------?------B----oXB-------------------------------------M-----o---------M-----o--o-----------?----B---BX-X--Boo---o------M--?XX----BoM--
-?-M--o-------X-B--o--------------M--------B---X---------------o-----M---o----------------M-oo-B?------------------X-?----X-o-X-?X-------M----XB-----o---o------Bo--B---o--X---------M----B----o--B---X-
---------o-??--------o--X-?------------X--------------?----X-?B--XoX-------X--------M-?---------------oX--oX--BX----------------E-X--B?---X-o--X-X--------?---------------X----M---X---------?X--M--X---
-M-----M------X-X------X-----?-XM--o-X--X-----X-----X----------M--------M--------o-----o--o-X---o?---X-----------o--B------X-M--X--?-----o------M----oX-----Bo---MoB--X------M--o---o----X--------------
-----------M?-o---M--o-X---------------------M-----B---------X---------------B?o---o-BM--X---M----o-----------B--o---BX-------X--?----------MM-----B-o--X--X-------B-------------------------o------o--v
-----X-X------------------------X?-?-----?Bo--?X-o--X---------M-----------o-o--------------o---X----o----X---M-o--X-----o---oM----------X------X------X--?-----X--?---o-----------o-o-X--o-o------X----f
---o----------------X-?-------XB------oB--------X-B------B-------o------?----MBXBo-----X-M------X---B---------?XX--o----X------XBo-------o-X-------X---o-------------o-X---MM--o--X--M-o--oo----X------f
-------?Xo?---B----------------X-----o---o--B--B-X----?----XX------o----------------------oX-X-o-?-o--o----MX----X------------B----------o--XE--------------M--X-------------o---M----M-----oM---------f
---XX--------M-M-o-----o--o-o---Xo-----------o-Bo--o----o---------?--X-M--o-----X--B-----------B--------X------B-----X-o--o-X---B--Mo------XXX?-------M-o-M-------XM-M--------M------------B--o-X-----Xf
-------X----E----------oX---X--B--X-X-XB--oXoX---------o--M-----o------------Xo---o----X--ooX----M------o---B-----X--------------X--------------B-------o-----?-----------o-----------?--XX-------oX---f
------o-----X?--o--o-------M--o-X----------------o--o--------------XXXo---B-M--B-o----------------M-?MX----X-B-o?--X------------o-M-o---X?X--B-B----M------------------B-XX?-BX---oo------B-B---------Xf
m-X-----X--X--BoX-----------X---X---B---------X-B----o----XB---------------------X-----X----------------oXo---B----XoX-X--------------o------------------X--o--oB--X-X------o-o-----X---XXXB--X-------XX
XXXXXXXXXXXXXXXXXXXXXXX-XXXXXXXXXXXXXXXXXXXXXXXXXXXXXXXXXXXXXX-XXXXXX--XXXXXXX-XXXXXXXXXXXXXXXXXXXXXXXXXXXXXXXXXXXXXXXXXXXXX-XXXXXXXXXXXXXXXXXXXXXXXXXXXXXXXXXXXXXXXXXXXXXXXXXXXXXXXXXXXXXXXXXXXXXXXXXXX
