--------------------------------------------------------------------------------------------------------------------------------------------------------------------------------------------------------
--------------------------------------------------------------------------------------------------------------------------------------------------------------------------------------------------------
--------------------------------------------------------------------------------------------------------------------------------------------------------------------------------------------------------
-----X---------------------------------?--o---X--X--B--B-M----o-----?M-------o-----BX-------------X?-?--?-------M-B-------------B--X-X-MX?B------X-----X------B-?XX----o-----------------------------XX-
-M-B---B----X-M?-o?X----B--X-XM----------o----B-o--o------B-----o-----Bo-o----------o-X-X-?--M--X-----------M----?--o---BX----------B-------?-o--BM--X-o--o--------M----------M-X----BX-B-X-----X?------
-----------X-----------X-o?-X-----X?---X---------------o-------X---X?---------?--XB------------o---o-X-X-X---X----MX-------B-o-?-oo------M--------------oX-----------Bo---o-X------?-----X-B-------M--o-
--XX---XX--------B----o---------M----------------X-----o-----M---------Xo------X------------------X---X--------XM--------------------o-o-----o-------o-X-X-o-o?-X--Mo-X----M----M-------------X--?--oo--
-X---o-------------B----X---o------X-----X---o-----XBX--X-----o------M----?-B---X--X----X----------------X---?--------X---o---------?----??----------B------B--?-?---?-?----B-?-------o?-----X---------v
---M-XMo-B?--X------------B-o-----------o--o---B---X--B----XX---XM-------------------------X-B-o---B?----------X-X----------oM--------------o-M-XoMBB-?--?X-oX-----------o--B----oX-----------oB----M-Xf
-?--?---M----o-------X---o-------X---X--------o-B---------E--------M-M--o-X------oo?----o-----o--M---?------X-----?-------------------X---------------------------?-----B--X-B-X----?------------------f
---------MX---o---X-X-B--o?-X-X-------------o--X-MB?------B--o--X-----o-----X--------M-----o--o---------?-?-B--------o?X-----XB--------o-X------XX------M---oo-----BX----M---o--------XX-X----XM----o--f
---------------X--------X---X--?---M-------M---o------o---X---------o--M-----------------X-------------------o---o-X-------------Xo---------B---------X----------X----------------M---------M---------Xf
--?--X-M-------B-----------X----o---oX--X-------------o--X-X--M------B-------o--X------------X--------X----o-----X--ooM-X?---o-?o-o---X-X---------X-B-X---X----o-o---XM--------X----X-B-MX-----X---X---f
----X---------o--?-o-----oX-------B--------o?----o--M?-X---BX------M--X---B---o--X--------B----------X-------------?------------------------------X-XX--o----X---------B---X-o------o----X--o---X-B----f
m-----X------------o--------B------X-XX---X--X----------X--o------------------------XB-X---B---XXXX----------X---------X-----X-X----o----XoX--X----B-------X-B-----B-----------------XB--BX----B--B---XX
XXX-XXXXXXXX-XXXX-XXXXXXXXXXXX-X--XXXX-XXXX-XXXXXXXXXXXXXX-XXXXXXXXXX--XXXX-XXXXX-XXXXXXXX-XXXXXXXXX---XXXXX-X-XX--X--XXXXX-X-X-XXXXXXXXXXXXXXXXXXXXXXXXXXXXXXXXXXXXXXXXXXXXXXXXXXXXXXXXXXXXXXXXXXXXXXXX
