--------------------------------------------------------------------------------------------------------------------------------------------------------------------------------------------------------
--------------------------------------------------------------------------------------------------------------------------------------------------------------------------------------------------------
--------------------------------------------------------------------------------------------------------------------------------------------------------------------------------------------------------
---B----------------MX--X-----------------------X----M-------?M-X-E----o-X---------------M--o-----------o-X--MM-X-----E-MX-------------o---?-?-------M----o---------X--------X--M---?-o-Xo--o-----------
-------------o-------o---X-----------M--B-X--X--------o-?-------o-XM?----------o-X---------------BM---?--M-?-------o--X----M-------M--B----------M-X----B---------------oX-------?X------oX-X--M-o-B--X-
----X---?-X--X?o-------XX--X-o----X-----X----X--X----------M-----------M---?-o--XX--M--------X--------------X-o-o-?-Xo------XX--?-------oB--X?------------oX-MX-----------X----X-------X--o--X---B--o---
---X-------?---Xo-M----------X--------------X----B------M-----o-X--?-------------------------------------o-B---------o-----o------XX-------o-------X--M-BX------o--X---o------B--o-----X--------o--M----
---X---------X-----B-------XX--------Mo--o---?-----------------------oX----X-----XX---X----------X---B-o-----B----MX-----B-----?-M-----o-----X-o---------X-----X-----------B-X-----M-?------?----o-----v
-------------X---X----------o------------X-----Mo-------X--X-?-------------------------X-MB---------X---Xo------------?----o-M------o-------------o-------?-----X---o-oB---------------o-M----------X--f
---B-?--B-----?-oX-----X-B-?--X--------------X------X-----B---X-M-----E---M-----?------------B----BX----------------?--------------o---------?MM---o--MoM---------?-------?-----MooX---o--XB---X-------f
--X----X------------?---M---XM---------X------?------M----------------X----X-------B?-------X----------------XB-oXo--o--------------------------M--o-------o-------o-o--X-----M--B---oo---------M-M--X-f
-------X--X------M-------oX---?------------?B------------?-----o-X----o------?---?---o--X----oMB------------MX----------------B--------B--M-oM-------o-?-XX-X------X-------oX-----X----o-M---X-----o---f
----X-----------------------------------X----M---oM-------?--E----------o------------X-----X--------B?---------oX------B-------B--------------X-Xo------o-----XX?------------------MX-X---o-XXM-EB--X--f
-----------M----o-------------oX--B--o-XX------M------X------X-----?---XX-M----M--X------?----------------X-o---o------------XM--X-X-oX-------Xoo------------------B-M--X-o-----o----X--X-------XB----Bf
m-----------X--------X--X--BB-------o------------B-----B------X------o-X------------------Xo---X----------B------------X-------X--XX---X---------Bo------XX---X-XoXB------XX--------X--Xo-X--X--X-B---XX
XX--XX-XXXXXXXXXXXXXXXX-XXXXXXXXXX-XXXXXXXXXXXXXXXXXXXXXXXXXXXXX-XXXXXXXXXXXX-XXXXX-XXXXXXXX-XXXX-XXXXXXXXXXXXX-XXXXXXXXX-XXXXXXXXXXXXXXXXXXXXXXXXXXXXXXXXXXXXXXXXXXXXXXXXXXXXXXXXXXXXXXXXXXXXXXXXXXXXXX
