--------------------------------------------------------------------------------------------------------------------------------------------------------------------------------------------------------
--------------------------------------------------------------------------------------------------------------------------------------------------------------------------------------------------------
--------------------------------------------------------------------------------------------------------------------------------------------------------------------------------------------------------
-X-B-------o----MX---------------o-XX-B--B-----------o----X--------X---------------o---------X-X------XX---o------X----X-------X--oo-------------------X--------o------X-X----------X--?----------M-----
-----o-X----X----o---?-o-XB-------------X--?------?---------o---M-oX--------?M-Xo-------MB-------------------B--------X--o------o-----MoX--o-o-B---oX---------X-----X-------------o--?----X-------------
---?--o-----X---X----------B--X--------XX----------B-X--o--B-----------B-------------B---X--------?---------------o------------B--------X---B---?-o--XXo---------B?------------M--XX--------B-----------
--------X--------XX---M----X---M----o-MX--Xo---X---o-----o-B----o----------X---B------o----oB-------?-----X-B----------X--o-------?--o-------?----X--o---------o-----------o----------------X----B-?----
-----M------?---o--------o------------------o---o-----X--------o------o----o-------------o---o-X----------------X--------?-----?----------------M--B-----o-Xo----B--M----------?B--------?-o----X-----Xv
-M-------------o-----MX--o--oo--X-------oB----o-------------?----?----------------?------------------------B----X--o---------------MMoM------B-----X--X------?--M------X-X---------oB-B----------------f
--------------?-o-----o----Xo------------B--M---MX-X--?-------------------------o----MX---------------X------o-------------?-?-X-?-------o-XB-o-X------B-?-------M---o---------X--oX---o--X--X---o----Xf
------------o-----X------X-------------X----------X--------B----X------------------o---o-B-BX--------B----------------------------Mo---o--B-----X-o--?-X--o---------M-----M------X------------M-----?--f
------oXXXB--XXMXX-X-XM-X-XX--XXXXX--XX--X-X-Xo----BB---X----XXX---XXX-XXXXX-X---X?-XXXX--X-----XXXX----X--X-XXXX?--XX-XX--oM-X----X--------M-------------------------X-M------M------o--X-X----X------f
-----X-------------------M--T----------o--------X-----X-----oX--MX----M--------oX----o--------B-----X----?---------------------------o-------B------?-o---------B----B---------------To--------B----M--f
------------XX----B-M?------|-M?----------X-X---------X-o-X---o---M--------X--------?---o-Xo----------------M------------X---?--B-M-?-X---------o----B-----B-----------X----B---o-Xo-|---XXM---X-----?-f
m--X-X---------X------------X-------XX-X------X--X----B-X----o--X--------X--------------------------X-------------------------o-------X----X--o-X-X------o---Bo---o---oX-------X--X--XB-o----oX--XX----X
XXXXXXXXX-XXXXXXXXXXXXXXX-XXXXXXX-X-XXXXXXXXXXXXXXXXXXXXXXXXXXXXXXXXX--XX--XXXXXXX-XXXXXXXXXXXXXX-X--XXXX-XXXXXXXXXXXXXXX-XXXXX-XXXXXXXXXXXXXXXXXXXXXXXXXXXXXXXXXXXXXXXXXXXXXXXXXXXXXXXXXXXXXXXXXXXXXXXX
