--------------------------------------------------------------------------------------------------------------------------------------------------------------------------------------------------------
--------------------------------------------------------------------------------------------------------------------------------------------------------------------------------------------------------
--------------------------------------------------------------------------------------------------------------------------------------------------------------------------------------------------------
-------X--------------------------------------o--M-------------------------M--------X?------X---M---o---M-----?-------------?---------?----X------X----------------------------------------------?------
---X-------------------X---------M----oX---------M---oo----------M----X----------?----------------?---?-o--X----X------------------M--o-X-----B----X------B------------X-----------?------X-------------
----X--?-----------X---------X-Xo-X-----------X------MB---?--X-?---------?-?----?--?--------BX--------------B---------?-------------X-X------------------X---o----X--------MX------?--X-----------------
--------------------------------o---M-----------------M---------------------o---B----------------?--------o---M-o------X---M-------?---?-o-------------------M--X--------------------X------------------
-----X----------------?------M----?----o-----M-----------?-----------?------X-----o----------------X-----------------------------------------------------------------X---X------------M---M------B-----v
--------------------------?------M-----M---------X------?-M--------X------------X---------------M-----------------------X------------------?-------XB------------X------------------M-----o---B--------f
--X-------------------X-------------o------X-----------?------------------o-------------------M-----B?---o----------------------X--------B----o---------------M----M------------X-?--------------X-X---f
-o--B---o------------------M----------------------------------B-------?----X---o----------------------------------------------------M---------------o-----------M-----------X-------------------M?-o---f
---------------X----X---X-------X--X------------------X--X-o-XX--------XX?--X-----XX-----M----X-----------X-X-------X--X--X-----o------------------?-------------------------------B--------X?-?-------f
------?---------------------------------------X-------------o-----------X--------B------------------------M-o-----------------o---------o-------B------------M------?--M-----------M------o--------T---f
--X--------B--------XM--------?----B--------------------X---------X------------MM-------------M------------------?----------------------X-----------------B---M-M-?---------B?----------------X----|--?f
m--------------------------------------------------------------X--------X---------------------------------------------------------X----o------------------B-----------------X-------------B---X----X---X
XX-XXXX-X-XXXXXX-XXXXX-XXXXXXXXXXX-XXX-XXXXXXXXXXXXXXXXXXXXX-XXXXX-XXXX-XXX-XXXXX-XXXXXXXXXXXXXX-XXXXXX-XXX-XXXXXXXXXXXXXXXXXXXXXXXXXXXXXXXXXXXXXXXXXXXXXXXXXXXXXXXXXXXXXXXXXXXXXXXXXXXXXXXXXXXXXXXXXXXX
