--------------------------------------------------------------------------------------------------------------------------------------------------------------------------------------------------------
--------------------------------------------------------------------------------------------------------------------------------------------------------------------------------------------------------
--------------------------------------------------------------------------------------------------------------------------------------------------------------------------------------------------------
-oXoo-X-B----------M------X---MX------------------------X---oo------------------------------M---?--M------o----------------X-----------X----X-X-X--X------o---oM------o---o------------o-?--------X-----
---------B?-----M------M---------o-------X--B---------o?-X-------------B--o--?---------X-----o--------X-X-X----oM---?---------o----Xo----X-----o-----------X-----X---M---X------------oo--X-o---B--M----
----o-X-----------X-------o---M---MX--M-X--------X--------BXX-X-----------------------------?-?----------M--M-?------------------XX--X----X-----X-X--------X-----B-----Xoo----B-o-----------X--X------B-
------E---o--X?M-X-o---?o--------------X--M-----X---B-----------B--X?--?---?-X----B---oX-o--------B--o---------?o------------X--M--M-----X--------o---X-E----------X----o--------B----X----o----Xo---X--
-o--o-BX-X--?------XB------------?-------------?------X-----M----B------?--------X--o-X------o------------X------X-BX-oo--?M-----------XB----Xo----o---B?------o---------X-X--XX-------------X-----o-X?v
---o-------------------o------MX----M---X-X-----?--------------X-----------o-o----X-----E-----XX-X------------?---M---------o----X-X--M--X--X----M---X----X--------?B-------oXo-X-o--X-----o-----------f
---------------------?--X--X-------------M--o-------XM-B--M--X--M--------------X----M---X-M-o---------M--B---------XX-MX-----o--o-M--------X---------B---Xo----o-o-----B----o--MX--XX-?Mo----o---------f
----B---M----X----Xo----------B------o-------E---X----X------------------X--E--------X--------X---------X-------B---------------------X-X---------o---------------o---o------------B-------?-----Xo?-oXf
-XXX-X----XX-X-------XXXX--X--X---MX-B-X-oX-oX-X-XXoX---Xo-X----XX----XX?X-XX--XXM-XXXX-XM-------X-X-XX-----X--XXXX-o-MX------X?-XXB-----ooB-------B--?-------M-------X-o---M-X-----X--XX-----?-M------f
-X-------o---------------X------X-------o--o--MX------MX----X-X----X---------oo--------o----------o-X----X?--------------BXMX------X-XX--o-------o--------o-B--------o--X-o--B---o------B--Xo----X----Bf
-------------?------------Xo-B------XM--------------------o----B--?--XB------X-M--?--------------------XM---M------MM----o-----?--?-----o---o--M----?M-o---?-?--X---------------X--B-BXB---o-----------f
mX-----o---------X---B----X---o---B------oB---------X-------XX-------X--o-------------X--X---------BX-----------o------o----------------o--X----o-----X----------X--B----------o-------X-X-----X-----XXX
XXXXXXXXXXXX-XXXXXXXXXXXXXXXXXXXXXXXXXXXXXXXXXXXXXXXXXXXXXXXXXXXX-XXXXX-XXXXXXXXXXXXXXXXXXXX-XXXXX-XXXXXXXXXXXXXXXXXXXXXXXXXXXXXXXXXXXXXXXXXXXXXXXXXXXXXXXXXXXXXXXXXXXXXXXXXXXXXXXXXXXXXXXXXXXXXXXXXXXXX
