--------------------------------------------------------------------------------------------------------------------------------------------------------------------------------------------------------
--------------------------------------------------------------------------------------------------------------------------------------------------------------------------------------------------------
--------------------------------------------------------------------------------------------------------------------------------------------------------------------------------------------------------
------X-B--------XX----o-o-------------X----o----Mo---X-------M---o-X------X---o---------XB------X----------B--------B---oXo--M--------------M-X-------------?---------M----B--o-o-MX--B----o---X-B--XM-
--X-----------B---------M-----M---Mo------XB--------XX----B-------------XX--o--o-----X-B-----X---------o----X-X-----X-----------------------------------o---------oo-M------B-M-X-------------B---------
-----X----oX---X-o----M---o---------o---X--------M-XX----X--X----o---Xo--XB?----------------M----X----X--------M----o---------oX---X--BXM-X---B-----o-----X--o----o---XX--------------o------X-M-?--B---
---BBB---XX--MX---X--------B--------X-BM--------------------X----------?----M--X-M--?--?----------B---B-?---?---------X---XM?--XX---oo-----------X---o--------X------------------X--X---X--oX-------X---
----E-----------o------o-X----E--X------X-M-o-------X--X-?---o-X----------o---o-----------o---X--M-M------------X----o--X--------X---------M--M----X----X------------XM---o----------X----------------Xv
---o?------X-o---X-BX---------M------------XX-X----X--------------------?----o-------------MXX----------X----Xo---X-M------?X-----------------------X------?B-MX----------B----o-XX-B-----X-B------?X--f
-----o---X-o------M------------o-----X---o-----X---o--------o-X---X-------------------X--o-----------------------X------------?---M-X------------------o-----------B-o-X-----o---------------X-M-X-----f
---X-o-------------X----?M-B------X----X-----M?X-BM-X----BM--o--------o---o-X-----------X-------XBo--o---o?-o?------M-----------X-------X?B-------X-----------XB---X-----B-o--MX?------X--------X--X-o-f
-M----------X-X-------------------------o?------------o----X--B-o---o--M---X-----B-Xo-----X----?------X-------B--X---MM-o-ooXM-X---M-?XM----M-X-XXXX-X-o-o------------oB-----------B----MM-o-----M--o--f
--o----------------o-o----X---XM----o-----------X------------?-o---X---------o---o---?-----------X-o---Xo-o-------M-----o--B---X--------------------------M---o-?--B-----o--o-M--B---o--------?-------Xf
---B---?----X--o---XX------o-B-----------B-----------E-M---------XX--o---------o----------X-------------------MX---X---o-----MX--o--M-----X----X?X-oXM--------------?B--M------oX--M-----------X-----X-f
m--o------X----------------------o------X-o--X--X-o--X----Xo----------X-X-----------o-----B------X-------------B--------o-X-----------XX---------------o-XX--oo--X----X--oo--X--B----XX-X-XX-ooXo------X
XXXX-XXXXXXXXXXXXXXXXX-XXXXXXXXXXXXXX-X-XXXXXXXXXXXXXXXXXXXXXXXXX-XXXXXXXXXXXXXXXX-XXXXXXXXX-XXXXXXXXXXXXXX-XXXXXXXXXXXXXXXXXXX-XXXXXXXXXXXXXXXXXXXXXXXXXXXXXXXXXXXXXXXXXXXXXXXXXXXXXXXXXXXXXXXXXXXXXXXX
