--------------------------------------------------------------------------------------------------------------------------------------------------------------------------------------------------------
--------------------------------------------------------------------------------------------------------------------------------------------------------------------------------------------------------
--------------------------------------------------------------------------------------------------------------------------------------------------------------------------------------------------------
--X------o------M-------o----?---------M-------------o----XB-----M------------------?M----B----------?-X--X--------------XB-------?------o-o--------B--------------------o-----XoM----------M--------?--
----oX------X---------X--o------?---o?--B-------------o-----o------------X-o-M-?------X-----M?oX--X------------o-B-------o--X-------------------B?------------------X-------------------X--------X------
------o--?X-----X-X---------------------X-MX-o---X--M--------M-------X----o------X------XX------o-X-?--------X-------oB------M--o--X---------------X--X--o----B--B---M---M---X-----X----X-M-B?----?M----
------------?--------------X-------------------X--X----X-----------------B----o-----BXoM---oB--------o------X----?---X------------o-----?--??-o-M-X------o---o----X----M---------X---------B--o-B-------
----------X---M-o-?-M---o-----o-------X--X--MB--?--------M-----------------?--o--X------B----o----X-----------X----o--B-------?BM---M-X---------------------o-------o--------------X----X----------?M--v
----------------------X?---X---X--B-----------X---o-B--------------X--------M--o---?-M------M-X-?-B---------?-X-------B----o-----X---o--------X---M--X---X-----------------------o------EX----B------?-f
-o--------------o-------M--X----o-----M--------------o-----------X-------B-------------o------X-----M-----X--o----o------M--------------o---M---o---X--B--X--------X--------------X---X-X---o------o---f
----------o-------XoX---------------o----X---------E-X----o-X------o-----o---------o-------BX--o----------B-B--------------------M--?B----o---o----------M--M--------o---X--X----X--------X-----o---o--f
--XX-XoXX---XXXXoX-XXXXXX-XX--B--X-X--o-----XB--X-MX--XXXX-BoXXX-----X-XM--XX-----X-X?XXX?X-XX--B--oXB--X----o-MXX-X?-oMXX-XM-X-------oB--X-o----o-X---------oM------------M-oM------------X-B-----M-o-f
---------X------B-----------------B-X---?---o--oX--------B-------B--------B----oX---------XX--B--------M----X---------------------oMo----?-B-B------B-o---Xo----------X---------?----B-----X-B-X-------f
-----------------X--o--o---X--M??---------X--o---------X----M--XX-X-----------M--X--?------oX----X-------------X--X--o----X--------------------------------X-o-----X------------------o--BX---XX----X--f
mX--X-oX-----X-X---B--------X-------------------Xo--X---o----------o---B-X-----B-------B-X------X-X---B---------------X--X-----oB----------B--o-X-X---------oB---------X--BX---X--oX-X-Xo-----X-------XX
XXXXXXXX--XXXX-X-XXXXXXXXXXXXXXXXX-XXXXXXXXXX-XXXXXXXXXXX-XXXX--XXXXXXXXXXXXXXXXXXX-XXXXXXXXXXXXXXXX-XXXX-XXXXXXX-XX-XXXXXXXXXXXXXXXXXXXXXXXXXXXXXXXXXXXXXXXXXXXXXXXXXXXXXXXXXXXXXXXXXXXXXXXXXXXXXXXXXXX
