--------------------------------------------------------------------------------------------------------------------------------------------------------------------------------------------------------
--------------------------------------------------------------------------------------------------------------------------------------------------------------------------------------------------------
--------------------------------------------------------------------------------------------------------------------------------------------------------------------------------------------------------
----o-----XM------X-?------X-------------X------------------------X------o--X------X---o----X-M----X--------------------XX--------MXB---M-o------B-------------X-----M-X--------X------ooX-----X--oB----
--X-X----B----X--------o------------X---B--B?-?------------o-------M--X-----------oo-X---------?----o-------o?-----X------B----B-----------------X--X-X-EX----o------------X------X----o--Xo-X-----oM---
-----B-B--?-------X---------?--oX-----B--------------?-------M--X----MX---o--M--B---------------M-------XX-M--B-----------XB?-o------oo--------------o--X----X-------B-----o---------B-------X----------
-M---------?-----------------X---M-?------MX---------------B------------?o-----------o-MXo--------?-X-------------------o----------X---X---o-------o---o---XX---X-----M?o-------------o--X----X-M?--o-X-
----?-oMXX---------------------------------------B----------X---B-o-------------oo---------X----M-----X----------o----B---X?---o--X---?o?------M-------Bo--X-----?--X-----o----------o---o?---------B--v
----------o--?-----X----o--XBM-----?---?------B--o--o----X-?-------M--------X------M----------o--------X----?--------o---B---------?-----B---------------B--XM-------X---M-X---------B-----X-?----X---of
----M---------o-----B?----X---------o-----o----X---X-----------------oo--X-------------X-----B-------------------?-----X-----oo------?----X---X--X--X--B---------X---X-E---------X--o--XX--------B-----f
-?--------?------B------o----?-X--------------?--B---X-----XX-o------o--o--B-----o------------------M--?-------?-------X--?-----------?----?--B---------o--MM----------X------o-------?-E--------o?----f
------X----M--------X-o----X-----o-----M--M----?M---X---X---o-X----------M--o---o---------------M--------X------?---X---o------o-------------------X-X----------o-X--o-----o-X----------X------X?---X--f
-M?---o------M?---X--Xo-----X---------------o------------------B-----X---------------------------------o------X--B-----X-------oEB------X------o-oB-X-o-M------------X------------X--oo--?o---X--oo--B-f
-----X----o--------------?M--?--X--X-----------o-X---------o--MX----XX----X----------M-------------------?---o---X----?-XX?--?--XX--X-X----B---------X----?-----M-B-----o--X----X-----X----X--Xo-----oXf
m------oX--oX-X------------B----o---X-------B-------X-------o---------o-X--B-X----X---------------X-----------------X------X------------o-------------X-------X-----X----X-X-o-o----------BX-XoX---o--XX
XXXXXXXXXXXXXXXX--XXXXXXXXXXXXXXXXX-XX-XXXXXXXXXXXXXXXX-XXX-XXXXXXXXX-XXXXXX-XX-XXXXX-XXXXX-XXXXXX--XX--XXX--XXXXXXXXXXXXXXXXXXXXXXXXXXXXXXXXXXXXXXXXXXXXXXXXXXXXXXXXXXXXXXXXXXXXXXXXXXXXXXXXXXXXXXXXXXX
