--------------------------------------------------------------------------------------------------------------------------------------------------------------------------------------------------------
--------------------------------------------------------------------------------------------------------------------------------------------------------------------------------------------------------
--------------------------------------------------------------------------------------------------------------------------------------------------------------------------------------------------------
------X-?--------E-------X----M----MX---?B--X-----o-o-oX-X--B--o-------o----------------oX--B----o---M---o---------B----------?o-X----------o------?---X---------X---------------------XM-o-B---X----B--
----X-------X----MXo------X-----??--o-X--X----B------------X--o---Bo-o------------B-o----------X------?------oB---X-----X--o-------X--X--o---o-X--------XX---------?---M--?-o------X--X----o-------o--M-
-----M---X----------X------o-----------XX-----o-X------M-X------o--------E-B--o-------X-------?-o---M---------X------X---B-X------X-?X------------------------X------------B---X-X?----------o--X-------
-o-o----------M--------oo--------?--X?----B----o-XM------------XX--------XMX---------------------XX--X--?-----------Xo-Mo-----------------Xoo-----?-------------B--X-------o-X-----?-B---B--X-----------
--oX-------X---X-------oE----XM-------o------o--M-E--X----BX-XB---------M---?-----------o-?----X---X----------------------?X-?X-----o-----o-----X---X----------------------------X------M----------o---v
--------?-----o---X-----XX-------B-M-B------------X?----X-------------o----------------------?o--------o---------------o---------X----------B---------XM--------M----B-----------o----o---X-----oo-----f
------------o---?-----------M-------------X-----o----B----X----o---------X---o-?----------------------X---o-X----?---X--------X----o---oM-B----------------------X--BB--X-X?---X---XB--o-----o---X-XX--f
---X----------X------M----------------BX---o-XB--?-Mo-----o---?-M--oBo-X--X------?XMMM---o--X----------------------o------------M-----o----------o--XX--B---------M-o---------Xo------------------?----f
--------X---o--B-XB----------M-M-X---X----o-X-------------------------o-X-------------------X-----o-----X------o-----------M-M-----X-o-M-o---X--X-----X-----X------------M---X--X--MM-----X-B?X-X----?-f
-o--X--M-X-M-----------X---X-----------BX-----X-------?--X--o------X---------o----------------??---?M-----?------------o-o-----XX-?--o-----o---X-X--?---??-oB-M-----------BoM--------B-B-?-X------XX--Xf
--M-----------------o-----X------X----------------?------------XM-----------X--Mo----o-----X-----X-----oB----------oXoo--o----------X---------?----------------M---M----------------X--------oX--o--X-Bf
m------X---X---X-----------B------B--------X----------X---X--B---------------------X-----------X----X------------X-X----o--o----o----XX------------------X--X--------------BX-----X-XB-X--X----X-BX---XX
XXXXXXXXXXXXXXXXXXXXXXXXXXXXX-X-XXXXXXXXXXX--XX-XXXXXXXXXXXXXX-XXXX-XXXXX-XXX-XX-XXXXXXXXXXX-XXXXX--XXXX-XXXXX-X--XXXXXXXXXXXXXXXXXXXXXXXXXXXXXXXXXXXXXXXXXXXXXXXXXXXXXXXXXXXXXXXXXXXXXXXXXXXXXXXXXXXXXX
